Ngày;MKH;Tên Tắt;DD chính;Lộ điểm đo;SL BT;SL CD;SL TD;Tổng SL;Tiền BT;Tiền CD;Tiền TD;Tiền trước thuế;Tiền sau thuế;Phạt Q Trc Thuế;Phạt Q sau thuế;Ngày thanh toán
11/02/2023;EVN-TH;EVN-TH;2046008583;TH484 E11.9;0;0;0;0;0;0;0;0;0;0;0;16/02/2023
11/02/2023;EVN-TH;EVN-TH;2046008580;TH486 E11.9;0;0;0;0;0;0;0;0;0;0;0;16/02/2023
16/02/2023;KCNTH-002;TH-Asahi;2210575757;TH486 E11.9;0;0;0;0;0;0;0;0;0;0;0;21/02/2023
20/02/2023;EVN-TH;EVN-TH;2046008583;TH484 E11.9;0;0;0;0;0;0;0;0;0;0;0;25/02/2023
20/02/2023;EVN-TH;EVN-TH;2046008580;TH486 E11.9;0;0;-418;-418;0;0;-413402;-413402;-454742,2;0;0;25/02/2023
20/02/2023;KCNTH-002;TH-Asahi;2210575757;TH486 E11.9;12;6;0;18;20220;18456;0;38676;38676;0;0;25/02/2023
28/02/2023;EVN-TH;EVN-TH;2046008580;TH486 E11.9;-418;-418;0;-836;-637868;-1177506;0;-1815374;-1996911,4;0;0;05/03/2023
28/02/2023;EVN-TH;EVN-TH;2046008583;TH484 E11.9;0;0;0;0;0;0;0;0;0;0;0;05/03/2023
28/02/2023;KCNTH-001;TH-BQL;2210575660;TH486 E11.9;0;0;0;0;0;0;0;0;0;0;0;05/03/2023
28/02/2023;KCNTH-002;TH-Asahi;2210575757;TH486 E11.9;102;36;36;174;171870;110736;39600;322206;322206;0;0;05/03/2023
10/03/2023;EVN-TH;EVN-TH;2046008580;TH486 E11.9;-836;-418;0;-1254;-1275736;-1177506;0;-2453242;-2698566,2;0;0;15/03/2023
10/03/2023;EVN-TH;EVN-TH;2046008583;TH484 E11.9;0;0;0;0;0;0;0;0;0;0;0;15/03/2023
10/03/2023;KCNTH-002;TH-Asahi;2210575757;TH486 E11.9;798;300;114;1212;1344630;922800;125400;2392830;2392830;0;0;15/03/2023
20/03/2023;EVN-TH;EVN-TH;2046008580;TH486 E11.9;-8364;-2927;-2927;-14218;-12763464;-8245359;-2894803;-23903626;-26293988,6;0;0;25/03/2023
20/03/2023;EVN-TH;EVN-TH;2046008583;TH484 E11.9;0;0;0;0;0;0;0;0;0;0;0;25/03/2023
20/03/2023;KCNTH-002;TH-Asahi;2210575757;TH486 E11.9;6954;2490;2430;11874;11717490;7659240;2673000;22049730;22049730;0;0;25/03/2023
31/03/2023;EVN-TH;EVN-TH;2046008580;TH486 E11.9;-12127;-4600;-4600;-21327;-18505802;-12958200;-4549400;-36013402;-39614742,2;0;0;05/04/2023
31/03/2023;EVN-TH;EVN-TH;2046008583;TH484 E11.9;0;0;0;0;0;0;0;0;0;0;0;05/04/2023
31/03/2023;KCNTH-001;TH-BQL;2210575660;TH486 E11.9;1768;779;507;3054;2979080;2396204;557700;5932984;6526282,4;0;0;05/04/2023
31/03/2023;KCNTH-002;TH-Asahi;2210575757;TH486 E11.9;11568;4392;4308;20268;19492080;13509792;4738800;37740672;37740672;0;0;05/04/2023
01/04/2023;EVN-TH;EVN-TH;2110155910;TH476 E11.9;0;0;0;0;0;0;0;0;0;0;0;06/04/2023
01/04/2023;KCNTH-001;TH-BQL;2310068751;TH476 E11.9;0;0;0;0;0;0;0;0;0;0;0;06/04/2023
01/04/2023;KCNTH-001;TH-BQL;2310068799;TH486 E11.9;0;0;0;0;0;0;0;0;0;0;0;06/04/2023
08/04/2023;KCNTH-003;TH-Hợp Lực;2310068830;TH476 E11.9;0;0;0;0;0;0;0;0;0;0;0;13/04/2023
11/04/2023;KCNTH-002;TH-Asahi;2210575757;TH486 E11.9;5976;2166;1260;9402;10069560;6662616;1386000;18118176;18118176;0;0;16/04/2023
20/04/2023;KCNTH-002;TH-Asahi;2210575757;TH486 E11.9;6318;2334;996;9648;10645830;7179384;1095600;18920814;18920814;0;0;25/04/2023
20/04/2023;KCNTH-003;TH-Hợp Lực;2310068830;TH476 E11.9;1175;516;788;2479;1979875;1587216;866800;4433891;4877280,1;0;0;25/04/2023
28/04/2023;KCNTH-001;TH-BQL;2210575660;TH486 E11.9;2316;1024;747;4087;3902460;3149824;821700;7873984;8661382,4;0;0;03/05/2023
28/04/2023;KCNTH-001;TH-BQL;2310068751;TH476 E11.9;7;0;0;7;11795;0;0;11795;12974,5;0;0;03/05/2023
28/04/2023;KCNTH-001;TH-BQL;2310068799;TH486 E11.9;78;16;0;94;131430;49216;0;180646;198710,6;0;0;03/05/2023
28/04/2023;KCNTH-002;TH-Asahi;2210575757;TH486 E11.9;5790;2208;1050;9048;9756150;6791808;1155000;17702958;17702958;0;0;03/05/2023
28/04/2023;KCNTH-003;TH-Hợp Lực;2310068830;TH476 E11.9;952;424;636;2012;1604120;1304224;699600;3607944;3968738,4;0;0;03/05/2023
30/04/2023;EVN-TH;EVN-TH;2046008580;TH486 E11.9;-23836;-8782;-5018;-37636;-36373736;-24738894;-4962802;-66075432;-72682975,2;0;0;05/05/2023
30/04/2023;EVN-TH;EVN-TH;2046008583;TH484 E11.9;0;0;0;0;0;0;0;0;0;0;0;05/05/2023
30/04/2023;EVN-TH;EVN-TH;2110155910;TH476 E11.9;-2350;-1034;-1540;-4924;-3586100;-2912778;-1523060;-8021938;-8824131,8;0;0;05/05/2023
04/05/2023;EVN-TH;EVN-TH;2046008580;TH486 E11.9;-1255;-418;-418;-2091;-1915130;-1177506;-413402;-3506038;-3856641,8;0;0;09/05/2023
04/05/2023;EVN-TH;EVN-TH;2046008583;TH484 E11.9;0;0;0;0;0;0;0;0;0;0;0;09/05/2023
04/05/2023;EVN-TH;EVN-TH;2110155910;TH476 E11.9;-308;-88;-264;-660;-470008;-247896;-261096;-979000;-1076900;0;0;09/05/2023
04/05/2023;KCNTH-001;TH-BQL;2210575660;TH486 E11.9;437;193;176;806;736345;593668;193600;1523613;1675974,3;0;0;09/05/2023
04/05/2023;KCNTH-001;TH-BQL;2310068799;TH486 E11.9;0;0;0;0;0;0;0;0;0;0;0;09/05/2023
04/05/2023;KCNTH-001;TH-BQL;2310068751;TH476 E11.9;0;0;0;0;0;0;0;0;0;0;0;09/05/2023
04/05/2023;KCNTH-002;TH-Asahi;2210575757;TH486 E11.9;2748;984;600;4332;4630380;3026784;660000;8317164;8317164;0;0;09/05/2023
04/05/2023;KCNTH-003;TH-Hợp Lực;2310068830;TH476 E11.9;533;239;424;1196;898105;735164;466400;2099669;2309635,9;0;0;09/05/2023
10/05/2023;KCNTH-002;TH-Asahi;2210575757;TH486 E11.9;3528;1224;672;5424;6131664;3881304;761376;10774344;10774344;0;0;15/05/2023
10/05/2023;KCNTH-003;TH-Hợp Lực;2310068830;TH476 E11.9;678;210;474;1362;1178364;665910;537042;2381316;2619447,6;0;0;15/05/2023
20/05/2023;KCNTH-002;TH-Asahi;2210575757;TH486 E11.9;8964;3960;1266;14190;15579432;12557160;1434378;29570970;29570970;0;0;25/05/2023
20/05/2023;KCNTH-003;TH-Hợp Lực;2310068830;TH476 E11.9;1238;592;847;2677;2151644;1877232;959651;4988527;5487379,7;0;0;25/05/2023
31/05/2023;EVN-TH;EVN-TH;2046008580;TH486 E11.9;-28436;-12127;-5018;-45581;-44758264;-35204681;-5108324;-85071269;-93578395,9;0;0;05/06/2023
31/05/2023;EVN-TH;EVN-TH;2046008583;TH484 E11.9;0;0;0;0;0;0;0;0;0;0;0;05/06/2023
31/05/2023;EVN-TH;EVN-TH;2110155910;TH476 E11.9;-3916;-1760;-2288;-7964;-6163784;-5109280;-2329184;-13602248;-14962472,8;0;0;05/06/2023
31/05/2023;KCNTH-001;TH-BQL;2210575660;TH486 E11.9;3135;1408;971;5514;5448630;4464768;1100143;11013541;12114895,1;0;0;05/06/2023
31/05/2023;KCNTH-001;TH-BQL;2310068751;TH476 E11.9;0;0;0;0;0;0;0;0;0;0;0;05/06/2023
31/05/2023;KCNTH-001;TH-BQL;2310068799;TH486 E11.9;0;0;0;0;0;0;0;0;0;0;0;15/06/2023
31/05/2023;KCNTH-002;TH-Asahi;2210575757;TH486 E11.9;11118;4752;1524;17394;19323084;15068592;1726692;36118368;36118368;0;0;15/06/2023
31/05/2023;KCNTH-003;TH-Hợp Lực;2310068830;TH476 E11.9;1948;869;919;3736;3385624;2755599;1041227;7182450;7900695;0;0;25/06/2023
10/06/2023;KCNTH-002;TH-Asahi;2210575757;TH486 E11.9;13230;4866;1566;19662;22993740;15430086;1774278;40198104;40198104;0;0;25/06/2023
10/06/2023;KCNTH-003;TH-Hợp Lực;2310068830;TH476 E11.9;2852;1258;1165;5275;4956776;3989118;1319945;10265839;11292422,9;0;0;05/07/2023
20/06/2023;KCNTH-002;TH-Asahi;2210575757;TH486 E11.9;11910;4650;1764;18324;20699580;14745150;1998612;37443342;37443342;0;0;05/07/2023
20/06/2023;KCNTH-003;TH-Hợp Lực;2310068830;TH476 E11.9;4003;1283;1624;6910;6957214;4068393;1839992;12865599;14152158,9;0;0;05/07/2023
30/06/2023;EVN-TH;EVN-TH;2046008580;TH486 E11.9;-50600;-21327;-7109;-79036;-79644400;-61912281;-7236962;-148793643;-163673007,3;0;0;05/07/2023
30/06/2023;EVN-TH;EVN-TH;2046008583;TH484 E11.9;0;0;0;0;0;0;0;0;0;0;0;05/07/2023
30/06/2023;EVN-TH;EVN-TH;2110155910;TH476 E11.9;-11088;-3828;-4532;-19448;-17452512;-11112684;-4613576;-33178772;-36496649,2;0;0;05/07/2023
30/06/2023;KCNTH-001;TH-BQL;2210575660;TH486 E11.9;3725;1485;1096;6306;6474050;4708935;1241768;12424753;13667228,3;0;0;05/07/2023
30/06/2023;KCNTH-001;TH-BQL;2310068751;TH476 E11.9;0;0;0;0;0;0;0;0;0;0;0;05/07/2023
30/06/2023;KCNTH-001;TH-BQL;2310068799;TH486 E11.9;0;0;0;0;0;0;0;0;0;0;0;15/07/2023
30/06/2023;KCNTH-002;TH-Asahi;2210575757;TH486 E11.9;20274;9978;2262;32514;35236212;31640238;2562846;69439296;69439296;0;0;15/07/2023
30/06/2023;KCNTH-003;TH-Hợp Lực;2310068830;TH476 E11.9;4234;1285;1802;7321;7358692;4074735;2041666;13475093;14822602,3;0;0;20/07/2023
10/07/2023;KCNTH-002;TH-Asahi;2210575757;TH486 E11.9;22374;9114;2766;34254;38886012;28900494;3133878;70920384;70920384;0;0;20/07/2023
10/07/2023;KCNTH-003;TH-Hợp Lực;2310068830;TH476 E11.9;6732;2006;3118;11856;11700216;6361026;3532694;21593936;23321450,88;0;0;20/07/2023
15/07/2023;EVN-TH;EVN-TH;2046008580;TH486 E11.9;-40564;-16727;-5018;-62309;-63847736;-48558481;-5108324;-117514541;-126915704,3;0;0;25/07/2023
15/07/2023;EVN-TH;EVN-TH;2046008583;TH484 E11.9;0;0;0;0;0;0;0;0;0;0;0;25/07/2023
15/07/2023;EVN-TH;EVN-TH;2110155910;TH476 E11.9;-10780;-3652;-4884;-19316;-16967720;-10601756;-4971912;-32541388;-35144699,04;0;0;05/08/2023
20/07/2023;KCNTH-002;TH-Asahi;2210575757;TH486 E11.9;23400;9660;2760;35820;40669200;30631860;3127080;74428140;74428140;0;0;05/08/2023
20/07/2023;KCNTH-003;TH-Hợp Lực;2310068830;TH476 E11.9;6616;2278;2920;11814;11498608;7223538;3308360;22030506;23792946,48;0;0;05/08/2023
31/07/2023;EVN-TH;EVN-TH;2046008580;TH486 E11.9;-39727;-14218;-6691;-60636;-63722108;-42071062;-6938567;-112731737;-121750276;0;0;05/08/2023
31/07/2023;EVN-TH;EVN-TH;2046008583;TH484 E11.9;0;0;0;0;0;0;0;0;0;0;0;05/08/2023
31/07/2023;EVN-TH;EVN-TH;2110155910;TH476 E11.9;-9460;-2772;-3916;-16148;-15173840;-8202348;-4060892;-27437080;-29632046,4;0;0;05/08/2023
31/07/2023;KCNTH-001;TH-BQL;2210575660;TH486 E11.9;4376;1697;1323;7396;7605488;5381187;1498959;14485634;15644484,72;0;0;05/08/2023
31/07/2023;KCNTH-001;TH-BQL;2310068751;TH476 E11.9;10;5;1;16;17380;15855;1133;34368;37117,44;0;0;05/08/2023
31/07/2023;KCNTH-001;TH-BQL;2310068799;TH486 E11.9;0;0;0;0;0;0;0;0;0;0;0;15/08/2023
31/07/2023;KCNTH-002;TH-Asahi;2210575757;TH486 E11.9;28212;9732;4548;42492;49032456;30860172;5152884;85045512;85045512;0;0;15/08/2023
31/07/2023;KCNTH-003;TH-Hợp Lực;2310068830;TH476 E11.9;6890;2119;2762;11771;11974820;6719349;3129346;21823515;23569396,2;0;0;20/08/2023
10/08/2023;KCNTH-002;TH-Asahi;2210575757;TH486 E11.9;24696;9330;3882;37908;42921648;29585430;4398306;76905384;76905384;0;0;20/08/2023
10/08/2023;KCNTH-003;TH-Hợp Lực;2310068830;TH476 E11.9;5933;2017;2390;10340;10311554;6395907;2707870;19415331;20968557,48;0;0;20/08/2023
15/08/2023;EVN-TH;EVN-TH;2046008580;TH486 E11.9;-40145;-15055;-6691;-61891;-64392580;-44547745;-6938567;-115878892;-125149203,4;0;0;25/08/2023
15/08/2023;EVN-TH;EVN-TH;2046008583;TH484 E11.9;0;0;0;0;0;0;0;0;0;0;0;25/08/2023
15/08/2023;EVN-TH;EVN-TH;2110155910;TH476 E11.9;-9064;-2992;-3564;-15620;-14538656;-8853328;-3695868;-27087852;-29254880,16;0;0;04/09/2023
20/08/2023;KCNTH-002;TH-Asahi;2210575757;TH486 E11.9;25776;10584;4512;40872;44798688;33561864;5112096;83472648;83472648;0;0;04/09/2023
20/08/2023;KCNTH-003;TH-Hợp Lực;2310068830;TH476 E11.9;6028;2263;2446;10737;10476664;7175973;2771318;20423955;22057871,4;0;0;04/09/2023
30/08/2023;EVN-TH;EVN-TH;2046008580;TH486 E11.9;-51018;-19236;-8782;-79036;-81832872;-56919324;-9106934;-147859130;-159687860,4;0;0;05/09/2023
30/08/2023;EVN-TH;EVN-TH;2046008583;TH484 E11.9;0;0;0;0;0;0;0;0;0;0;0;05/09/2023
30/08/2023;EVN-TH;EVN-TH;2110155910;TH476 E11.9;-10516;-3652;-4268;-18436;-16867664;-10806268;-4425916;-32099848;-34667835,84;0;0;05/09/2023
31/08/2023;KCNTH-001;TH-BQL;2210575660;TH486 E11.9;4592;1936;1245;7773;7980896;6139056;1410585;15530537;16772979,96;0;0;05/09/2023
31/08/2023;KCNTH-001;TH-BQL;2310068751;TH476 E11.9;31;2;1;34;53878;6342;1133;61353;66261,24;0;0;05/09/2023
31/08/2023;KCNTH-001;TH-BQL;2310068799;TH486 E11.9;0;0;0;0;0;0;0;0;0;0;0;15/09/2023
31/08/2023;KCNTH-002;TH-Asahi;2210575757;TH486 E11.9;31452;11112;5082;47646;54663576;35236152;5757906;95657634;95657634;0;0;15/09/2023
31/08/2023;KCNTH-003;TH-Hợp Lực;2310068830;TH476 E11.9;6924;2230;2828;11982;12033912;7071330;3204124;22309366;24094115,28;0;0;20/09/2023
10/09/2023;KCNTH-002;TH-Asahi;2210575757;TH486 E11.9;21732;8070;4020;33822;37770216;25589970;4554660;67914846;67914846;0;0;20/09/2023
10/09/2023;KCNTH-003;TH-Hợp Lực;2310068830;TH476 E11.9;6002;2243;2464;10709;10431476;7112553;2791712;20335741;21962600,28;0;0;20/09/2023
15/09/2023;EVN-TH;EVN-TH;2046008580;TH486 E11.9;-35545;-13382;-7109;-56036;-57014180;-39597338;-7372033;-103983551;-112302235,1;0;0;25/09/2023
15/09/2023;EVN-TH;EVN-TH;2046008583;TH484 E11.9;0;0;0;0;0;0;0;0;0;0;0;25/09/2023
15/09/2023;EVN-TH;EVN-TH;2110155910;TH476 E11.9;-8844;-3168;-3608;-15620;-14185776;-9374112;-3741496;-27301384;-29485494,72;0;0;05/10/2023
20/09/2023;KCNTH-002;TH-Asahi;2210575757;TH486 E11.9;23916;8760;4104;36780;41566008;27777960;4649832;73993800;73993800;0;0;05/10/2023
20/09/2023;KCNTH-003;TH-Hợp Lực;2310068830;TH476 E11.9;6826;2102;2434;11362;11863588;6665442;2757722;21286752;22989692,16;0;0;05/10/2023
30/09/2023;EVN-TH;EVN-TH;2046008580;TH486 E11.9;-42655;-16309;-7527;-66491;-68418620;-48258331;-7805499;-124482450;-134441046;0;0;05/10/2023
30/09/2023;EVN-TH;EVN-TH;2046008583;TH484 E11.9;0;0;0;0;0;0;0;0;0;0;0;05/10/2023
30/09/2023;EVN-TH;EVN-TH;2110155910;TH476 E11.9;-10560;-3652;-3872;-18084;-16938240;-10806268;-4015264;-31759772;-34300553,76;0;0;05/10/2023
30/09/2023;KCNTH-001;TH-BQL;2210575660;TH486 E11.9;4805;2062;1694;8561;8351090;6538602;1919302;16808994;18153713,52;0;0;05/10/2023
30/09/2023;KCNTH-001;TH-BQL;2310068751;TH476 E11.9;2;1;1;4;3476;3171;1133;7780;8402,4;0;0;05/10/2023
30/09/2023;KCNTH-001;TH-BQL;2310068799;TH486 E11.9;0;0;0;0;0;0;0;0;0;0;0;15/10/2023
30/09/2023;KCNTH-002;TH-Asahi;2210575757;TH486 E11.9;28644;10992;4602;44238;49783272;34855632;5214066;89852970;89852970;0;0;15/10/2023
30/09/2023;KCNTH-003;TH-Hợp Lực;2310068830;TH476 E11.9;7067;2534;2705;12306;12282446;8035314;3064765;23382525;25253127;0;0;15/10/2023
10/10/2023;EVN-TH;EVN-TH;2046008580;TH486 E11.9;-25509;-8782;-5436;-39727;-40916436;-25985938;-5637132;-72539506;-78342666,48;0;0;15/10/2023
10/10/2023;EVN-TH;EVN-TH;2046008583;TH484 E11.9;0;0;0;0;0;0;0;0;0;0;0;15/10/2023
10/10/2023;EVN-TH;EVN-TH;2110155910;TH476 E11.9;-7480;-2332;-2728;-12540;-11997920;-6900388;-2828936;-21727244;-23465423,52;0;0;25/10/2023
10/10/2023;KCNTH-002;TH-Asahi;2210575757;TH486 E11.9;22812;7920;4476;35208;39647256;25114320;5071308;69832884;69832884;0;0;25/10/2023
10/10/2023;KCNTH-003;TH-Hợp Lực;2310068830;TH476 E11.9;7454;2362;2720;12536;12955052;7489902;3081760;23526714;25408851,12;0;0;25/10/2023
20/10/2023;EVN-TH;EVN-TH;2046008580;TH486 E11.9;-27182;-10036;-5018;-42236;-43599928;-29696524;-5203666;-78500118;-84780127,44;0;0;25/10/2023
20/10/2023;EVN-TH;EVN-TH;2046008583;TH484 E11.9;0;0;0;0;0;0;0;0;0;0;0;25/10/2023
20/10/2023;EVN-TH;EVN-TH;2110155910;TH476 E11.9;-5720;-2244;-2288;-10252;-9174880;-6639996;-2372656;-18187532;-19642534,56;0;0;05/11/2023
20/10/2023;KCNTH-002;TH-Asahi;2210575757;TH486 E11.9;25044;9198;4254;38496;43526472;29166858;4819782;77513112;77513112;0;0;05/11/2023
20/10/2023;KCNTH-003;TH-Hợp Lực;2310068830;TH476 E11.9;5672;2236;2264;10172;9857936;7090356;2565112;19513404;21074476,32;0;0;05/11/2023
31/10/2023;EVN-TH;EVN-TH;2046008580;TH486 E11.9;-26764;-9618;-5436;-41818;-42929456;-28459662;-5637132;-77026250;-83188350;0;0;05/11/2023
31/10/2023;EVN-TH;EVN-TH;2046008583;TH484 E11.9;0;0;0;0;0;0;0;0;0;0;0;05/11/2023
31/10/2023;EVN-TH;EVN-TH;2110155910;TH476 E11.9;-5896;-2156;-2288;-10340;-9457184;-6379604;-2372656;-18209444;-19666199,52;0;0;05/11/2023
31/10/2023;KCNTH-001;TH-BQL;2210575660;TH486 E11.9;4954;2228;1918;9100;8610052;7064988;2173094;17848134;19275984,72;0;0;05/11/2023
31/10/2023;KCNTH-001;TH-BQL;2310068751;TH476 E11.9;0;0;0;0;0;0;0;0;0;0;0;05/11/2023
31/10/2023;KCNTH-001;TH-BQL;2310068799;TH486 E11.9;0;0;0;0;0;0;0;0;0;0;0;14/11/2023
31/10/2023;KCNTH-002;TH-Asahi;2210575757;TH486 E11.9;24780;8442;4638;37860;43067640;26769582;5254854;75092076;75092076;0;0;14/11/2023
31/10/2023;KCNTH-003;TH-Hợp Lực;2310068830;TH476 E11.9;5956;2170;2330;10456;10351528;6881070;2639890;19872488;21462287,04;0;0;14/11/2023
09/11/2023;EVN-TH;EVN-TH;2046008580;TH486 E11.9;-23000;-8782;-4600;-36382;-36892000;-25985938;-4770200;-67648138;-73059989,04;0;0;14/11/2023
09/11/2023;EVN-TH;EVN-TH;2046008583;TH484 E11.9;0;0;0;0;0;0;0;0;0;0;0;14/11/2023
09/11/2023;EVN-TH;EVN-TH;2110155910;TH476 E11.9;-5104;-1980;-1980;-9064;-8186816;-5858820;-2053260;-16098896;-17386807,68;0;0;14/11/2023
09/11/2023;KCNTH-001;TH-BQL;2210575660;TH486 E11.9;1640;840;530;3010;2850320;2663640;600490;6114450;6603606;0;0;14/11/2023
09/11/2023;KCNTH-001;TH-BQL;2310068751;TH476 E11.9;0;0;0;0;0;0;0;0;0;0;0;14/11/2023
09/11/2023;KCNTH-001;TH-BQL;2310068799;TH486 E11.9;218;71;56;345;378884;225141;63448;667473;720870,84;0;0;15/11/2023
09/11/2023;KCNTH-002;TH-Asahi;2210575757;TH486 E11.9;22596;9078;3600;35274;39271848;28786338;4078800;72136986;72136986;0;0;15/11/2023
09/11/2023;KCNTH-003;TH-Hợp Lực;2310068830;TH476 E11.9;5375;2258;1903;9536;9341750;7160118;2156099;18657967;20150604,36;0;0;16/11/2023
10/11/2023;KCNTH-002;TH-Asahi;2210575757;TH486 E11.9;1722;816;390;2928;3115098;2704224;461760;6281082;6281082;0;0;16/11/2023
10/11/2023;KCNTH-003;TH-Hợp Lực;2310068830;TH476 E11.9;420;149;229;798;759780;493786;271136;1524702;1646678,16;0;0;16/11/2023
11/11/2023;EVN-TH;EVN-TH;2046008580;TH486 E11.9;-2927;-1255;-418;-4600;-4885163;-3881715;-453112;-9219990;-9957589,2;0;0;25/11/2023
11/11/2023;EVN-TH;EVN-TH;2046008583;TH484 E11.9;0;0;0;0;0;0;0;0;0;0;0;25/11/2023
11/11/2023;EVN-TH;EVN-TH;2110155910;TH476 E11.9;-572;-352;-176;-1100;-954668;-1088736;-190784;-2234188;-2412923,04;0;0;25/11/2023
20/11/2023;EVN-TH;EVN-TH;2046008580;TH486 E11.9;-19655;-7527;-4600;-31782;-32804195;-23281011;-4986400;-61071606;-65957334,48;0;0;25/11/2023
20/11/2023;EVN-TH;EVN-TH;2046008583;TH484 E11.9;0;0;0;0;0;0;0;0;0;0;0;25/11/2023
20/11/2023;EVN-TH;EVN-TH;2110155910;TH476 E11.9;-5544;-1980;-2024;-9548;-9252936;-6124140;-2194016;-17571092;-18976779,36;0;0;05/12/2023
20/11/2023;KCNTH-002;TH-Asahi;2210575757;TH486 E11.9;16572;5922;3834;26328;29978748;19625508;4539456;54143712;54143712;0;0;05/12/2023
20/11/2023;KCNTH-003;TH-Hợp Lực;2310068830;TH476 E11.9;5339;1886;1966;9191;9658251;6250204;2327744;18236199;19695094,92;0;0;05/12/2023
30/11/2023;EVN-TH;EVN-TH;2046008580;TH486 E11.9;-22582;-9200;-5018;-36800;-37689358;-28455600;-5439512;-71584470;-77311227,6;0;0;05/12/2023
30/11/2023;EVN-TH;EVN-TH;2046008583;TH484 E11.9;0;0;0;0;0;0;0;0;0;0;0;05/12/2023
30/11/2023;EVN-TH;EVN-TH;2110155910;TH476 E11.9;-5412;-2244;-1848;-9504;-9032628;-6940692;-2003232;-17976552;-19414676,16;0;0;05/12/2023
30/11/2023;KCNTH-001;TH-BQL;2210575660;TH486 E11.9;2304;1268;1199;4771;4167936;4202152;1419616;9789704;10572880,32;0;0;05/12/2023
30/11/2023;KCNTH-001;TH-BQL;2310068751;TH476 E11.9;0;0;0;0;0;0;0;0;0;0;0;05/12/2023
30/11/2023;KCNTH-001;TH-BQL;2310068799;TH486 E11.9;804;234;189;1227;1454436;775476;223776;2453688;2649983,04;0;0;15/12/2023
30/11/2023;KCNTH-002;TH-Asahi;2210575757;TH486 E11.9;20052;7902;3996;31950;36274068;26187228;4731264;67192560;67192560;0;0;15/12/2023
30/11/2023;KCNTH-003;TH-Hợp Lực;2310068830;TH476 E11.9;5398;2275;1866;9539;9764982;7539350;2209344;19513676;21074770,08;0;0;15/12/2023
10/12/2023;EVN-TH;EVN-TH;2046008580;TH486 E11.9;-18818;-7109;-4600;-30527;-31407242;-21988137;-4986400;-58381779;-63052321,32;0;0;15/12/2023
10/12/2023;EVN-TH;EVN-TH;2046008583;TH484 E11.9;0;0;0;0;0;0;0;0;0;0;0;15/12/2023
10/12/2023;EVN-TH;EVN-TH;2110155910;TH476 E11.9;-4972;-2112;-1760;-8844;-8298268;-6532416;-1907840;-16738524;-18077605,92;0;0;19/12/2023
10/12/2023;KCNTH-002;TH-Asahi;2210575757;TH486 E11.9;16650;6222;3882;26754;30119850;20619708;4596288;55335846;55335846;0;0;20/12/2023
10/12/2023;KCNTH-003;TH-Hợp Lực;2310068830;TH476 E11.9;4996;2060;1738;8794;9037764;6826840;2057792;17922396;19356187,68;0;0;25/12/2023
14/12/2023;EVN-PĐ;EVN-PĐ;21041898;PĐ472;0;0;0;0;0;0;0;0;0;0;0;25/12/2023
15/12/2023;KCNPĐ-002;PĐ-AMP;2310231611;PĐ472;0;0;0;0;0;0;0;0;0;0;0;25/12/2023
20/12/2023;EVN-TH;EVN-TH;2046008580;TH486 E11.9;-18400;-6691;-5018;-30109;-30709600;-20695263;-5439512;-56844375;-61391925;0;0;25/12/2023
20/12/2023;EVN-TH;EVN-TH;2046008583;TH484 E11.9;0;0;0;0;0;0;0;0;0;0;0;25/12/2023
20/12/2023;EVN-TH;EVN-TH;2110155910;TH476 E11.9;-5720;-2024;-1804;-9548;-9546680;-6260232;-1955536;-17762448;-19183443,84;0;0;28/12/2023
20/12/2023;KCNTH-002;TH-Asahi;2210575757;TH486 E11.9;15450;5418;3696;24564;27949050;17955252;4376064;50280366;50280366;0;0;28/12/2023
20/12/2023;KCNTH-003;TH-Hợp Lực;2310068830;TH476 E11.9;5634;1992;1747;9373;10191906;6601488;2068448;18861842;20370789,36;0;0;05/01/2024
23/12/2023;KCNTH-003;TH-Hợp Lực;2310068830;TH476 E11.9;1822;965;530;3317;3295998;3198010;627520;7121528;7691250,24;0;0;05/01/2024
23/12/2023;KCNTH-003;TH-Hợp Lực;2310396109;TH476 E11.9;0;0;0;0;0;0;0;0;0;0;0;05/01/2024
31/12/2023;EVN-PĐ;EVN-PĐ;21041898;PĐ472;-8000;-4000;-4000;-16000;-13104000;-12136000;-4256000;-29496000;-31855680;0;0;05/01/2024
31/12/2023;EVN-TH;EVN-TH;2046008580;TH486 E11.9;-18818;-7109;-4600;-30527;-31407242;-21988137;-4986400;-58381779;-63052321,32;0;0;05/01/2024
31/12/2023;EVN-TH;EVN-TH;2046008583;TH484 E11.9;0;0;0;0;0;0;0;0;0;0;0;05/01/2024
31/12/2023;EVN-TH;EVN-TH;2110155910;TH476 E11.9;-6160;-2684;-2068;-10912;-10281040;-8301612;-2241712;-20824364;-22490313,12;0;0;05/01/2024
31/12/2023;KCNPĐ-002;PĐ-AMP;2310231611;PĐ472;7978;2866;1294;12138;14432202;9497924;1532096;25462222;27499199,76;0;0;05/01/2024
31/12/2023;KCNTH-001;TH-BQL;2210575660;TH486 E11.9;3188;1867;1759;6814;5767092;6187238;2082656;14036986;15159944,88;0;0;05/01/2024
31/12/2023;KCNTH-001;TH-BQL;2310068751;TH476 E11.9;0;0;0;0;0;0;0;0;0;0;0;05/01/2024
31/12/2023;KCNTH-001;TH-BQL;2310068799;TH486 E11.9;3473;1137;606;5216;6282657;3768018;717504;10768179;11629633,32;0;0;15/01/2024
31/12/2023;KCNTH-002;TH-Asahi;2210575757;TH486 E11.9;15456;5832;3498;24786;27959904;19327248;4141632;51428784;51428784;0;0;15/01/2024
31/12/2023;KCNTH-003;TH-Hợp Lực;2310396109;TH476 E11.9;4327;1742;1553;7622;7827543;5772988;1838752;15439283;16674425,64;0;0;15/01/2024
10/01/2024;EVN-TH;EVN-TH;2046008580;TH486 E11.9;-15891;-5436;-4182;-25509;-26522079;-16813548;-4533288;-47868915;-51698428,2;0;0;15/01/2024
10/01/2024;EVN-TH;EVN-TH;2046008583;TH484 E11.9;0;0;0;0;0;0;0;0;0;0;0;15/01/2024
10/01/2024;EVN-TH;EVN-TH;2110155910;TH476 E11.9;-5764;-2112;-1760;-9636;-9620116;-6532416;-1907840;-18060372;-19505201,76;0;0;15/01/2024
10/01/2024;KCNPĐ-002;PĐ-AMP;2310231611;PĐ472;1922;725;317;2964;3476898;2402650;375328;6254876;6755266,08;0;0;23/01/2024
10/01/2024;KCNTH-002;TH-Asahi;2210575757;TH486 E11.9;13476;4374;3456;21306;24378084;14495436;4091904;42965424;42965424;0;0;23/01/2024
10/01/2024;KCNTH-003;TH-Hợp Lực;2310396109;TH476 E11.9;5764;2087;1764;9615;10427076;6916318;2088576;19431970;20986527,6;0;0;25/01/2024
18/01/2024;KCNTH-001;TH-BQL;2310068799;TH486 E11.9;2164;735;430;3329;3914676;2435790;509120;6859586;7408352,88;0;0;25/01/2024
18/01/2024;KCNTH-001;TH-BQL;2310396108;TH486 E11.9;0;0;0;0;0;0;0;0;0;0;0;25/01/2024
20/01/2024;EVN-TH;EVN-TH;2046008580;TH486 E11.9;-18818;-7527;-5018;-31363;-31407242;-23281011;-5439512;-60127765;-64937986,2;0;0;25/01/2024
20/01/2024;EVN-TH;EVN-TH;2046008583;TH484 E11.9;0;0;0;0;0;0;0;0;0;0;0;25/01/2024
20/01/2024;EVN-TH;EVN-TH;2110155910;TH476 E11.9;-6248;-2640;-1804;-10692;-10427912;-8165520;-1955536;-20548968;-22192885,44;0;0;05/02/2024
20/01/2024;KCNTH-002;TH-Asahi;2210575757;TH486 E11.9;15870;6072;3720;25662;28708830;20122608;4404480;53235918;53235918;0;0;05/02/2024
20/01/2024;KCNTH-003;TH-Hợp Lực;2310396109;TH476 E11.9;6212;2605;1788;10605;11237508;8632970;2116992;21987470;23746467,6;0;0;05/02/2024
31/01/2024;EVN-PĐ;EVN-PĐ;21041898;PĐ472;-8000;-4000;0;-12000;-13104000;-12136000;0;-25240000;-27259200;0;0;05/02/2024
31/01/2024;EVN-TH;EVN-TH;2046008580;TH486 E11.9;-20491;-6691;-5018;-32200;-34199479;-20695263;-5439512;-60334254;-65160994,32;0;0;05/02/2024
31/01/2024;EVN-TH;EVN-TH;2046008583;TH484 E11.9;0;0;0;0;0;0;0;0;0;0;0;05/02/2024
31/01/2024;EVN-TH;EVN-TH;2110155910;TH476 E11.9;-6820;-2552;-1892;-11264;-11382580;-7893336;-2050928;-21326844;-23032991,52;0;0;05/02/2024
31/01/2024;KCNPĐ-002;PĐ-AMP;2310231611;PĐ472;5954;2218;763;8935;10770786;7350452;903392;19024630;20546600,4;0;0;05/02/2024
31/01/2024;KCNTH-001;TH-BQL;2210575660;TH486 E11.9;3406;1785;1805;6996;6161454;5915490;2137120;14214064;15351189,12;0;0;05/02/2024
31/01/2024;KCNTH-001;TH-BQL;2310068751;TH476 E11.9;0;0;0;0;0;0;0;0;0;0;0;05/02/2024
31/01/2024;KCNTH-001;TH-BQL;2310396108;TH486 E11.9;1852;608;405;2865;3350268;2014912;479520;5844700;6312276;0;0;06/02/2024
31/01/2024;KCNTH-002;TH-Asahi;2210575757;TH486 E11.9;16704;5406;3978;26088;30217536;17915484;4709952;52842972;52842972;0;0;06/02/2024
31/01/2024;KCNTH-003;TH-Hợp Lực;2310396109;TH476 E11.9;6746;2540;1831;11117;12203514;8417560;2167904;22788978;24612096,24;0;0;15/02/2024
01/02/2024;KCNPĐ-001;PĐ-BQL;2310231609;PĐ472;0;0;0;0;0;0;0;0;0;0;0;15/02/2024
01/02/2024;KCNPĐ-001;PĐ-BQL;2310231610;PĐ472;0;0;0;0;0;0;0;0;0;0;0;15/02/2024
10/02/2024;EVN-TH;EVN-TH;2046008580;TH486 E11.9;-15473;-6273;-4600;-26346;-25824437;-19402389;-4986400;-50213226;-54230284,08;0;0;15/02/2024
10/02/2024;EVN-TH;EVN-TH;2046008583;TH484 E11.9;0;0;0;0;0;0;0;0;0;0;0;15/02/2024
10/02/2024;EVN-TH;EVN-TH;2110155910;TH476 E11.9;-2860;-1188;-1452;-5500;-4773340;-3674484;-1573968;-10021792;-10823535,36;0;0;25/02/2024
10/02/2024;KCNTH-002;TH-Asahi;2210575757;TH486 E11.9;13212;5262;3504;21978;23900508;17438268;4148736;45487512;45487512;0;0;25/02/2024
10/02/2024;KCNTH-003;TH-Hợp Lực;2310396109;TH476 E11.9;2776;1189;1420;5385;5021784;3940346;1681280;10643410;11494882,8;0;0;25/02/2024
20/02/2024;EVN-TH;EVN-TH;2046008580;TH486 E11.9;-9200;-2927;-4182;-16309;-15354800;-9053211;-4533288;-28941299;-31256602,92;0;0;25/02/2024
20/02/2024;EVN-TH;EVN-TH;2046008583;TH484 E11.9;0;0;0;0;0;0;0;0;0;0;0;25/02/2024
20/02/2024;EVN-TH;EVN-TH;2110155910;TH476 E11.9;-2112;-748;-1320;-4180;-3524928;-2313564;-1430880;-7269372;-7850921,76;0;0;05/03/2024
20/02/2024;KCNTH-002;TH-Asahi;2210575757;TH486 E11.9;7668;2226;3150;13044;13871412;7376964;3729600;24977976;24977976;0;0;05/03/2024
20/02/2024;KCNTH-003;TH-Hợp Lực;2310396109;TH476 E11.9;2081;731;1308;4120;3764529;2422534;1548672;7735735;8354593,8;0;0;05/03/2024
29/02/2024;EVN-PĐ;EVN-PĐ;21041898;PĐ472;-9080;-3720;-3200;-16000;-14873040;-11286480;-3404800;-29564320;-31929465,6;0;0;05/03/2024
29/02/2024;EVN-TH;EVN-TH;2046008580;TH486 E11.9;-19236;-7945;-4600;-31781;-32104884;-24573885;-4986400;-61665169;-66598382,52;0;0;05/03/2024
29/02/2024;EVN-TH;EVN-TH;2046008583;TH484 E11.9;0;0;0;0;0;0;0;0;0;0;0;05/03/2024
29/02/2024;EVN-TH;EVN-TH;2110155910;TH476 E11.9;-3520;-1584;-1364;-6468;-5874880;-4899312;-1478576;-12252768;-13232989,44;0;0;05/03/2024
29/02/2024;EVN-YM;EVN-YM;2346021347;YM 472E28.6;0;0;0;0;0;0;0;0;0;0;0;05/03/2024
29/02/2024;EVN-YM;EVN-YM;3001347;YM 472E28.6;0;0;0;0;0;0;0;0;0;0;0;05/03/2024
29/02/2024;KCNPĐ-001;PĐ-BQL;2310231609;PĐ472;490;211;396;1097;886410;699254;468864;2054528;2218890,24;0;0;05/03/2024
29/02/2024;KCNPĐ-001;PĐ-BQL;2310231610;PĐ472;0;0;0;0;0;0;0;0;0;0;0;05/03/2024
29/02/2024;KCNPĐ-002;PĐ-AMP;2310231611;PĐ472;6674;2374;859;9907;12073266;7867436;1017056;20957758;22634378,64;0;0;05/03/2024
29/02/2024;KCNTH-001;TH-BQL;2210575660;TH486 E11.9;2569;1358;1586;5513;4647321;4500412;1877824;11025557;11907601,56;0;0;05/03/2024
29/02/2024;KCNTH-001;TH-BQL;2310068751;TH476 E11.9;0;0;0;0;0;0;0;0;0;0;0;05/03/2024
29/02/2024;KCNTH-001;TH-BQL;2310396108;TH486 E11.9;1401;600;790;2791;2534409;1988400;935360;5458169;5894822,52;0;0;05/03/2024
29/02/2024;KCNTH-002;TH-Asahi;2210575757;TH486 E11.9;17484;7194;3456;28134;31628556;23840916;4091904;59561376;59561376;0;0;05/03/2024
29/02/2024;KCNTH-003;TH-Hợp Lực;2310396109;TH476 E11.9;3479;1560;1366;6405;6293511;5169840;1617344;13080695;14127150,6;0;0;05/03/2024
29/02/2024;KCNYM-001;YM-VNC;2310396107;YM 472E28.6;0;0;0;0;0;0;0;0;0;0;0;05/03/2024
29/02/2024;KCNYM-002;YM-Thịnh Vượng;2310396110;YM 472E28.6;0;0;0;0;0;0;0;0;0;0;0;15/03/2024
29/02/2024;KCNYM-002;YM-Thịnh Vượng;2310396111;YM 472E28.6;0;0;0;0;0;0;0;0;0;0;0;15/03/2024
29/02/2024;KCNYM-004;YM-MQ-IDS;2310396106;YM 472E28.6;0;0;0;0;0;0;0;0;0;0;0;15/03/2024
10/03/2024;EVN-TH;EVN-TH;2046008580;TH486 E11.9;-23000;-9200;-4600;-36800;-38387000;-28455600;-4986400;-71829000;-77575320;0;0;15/03/2024
10/03/2024;EVN-TH;EVN-TH;2046008583;TH484 E11.9;0;0;0;0;0;0;0;0;0;0;0;15/03/2024
10/03/2024;EVN-TH;EVN-TH;2110155910;TH476 E11.9;-5896;-2376;-1628;-9900;-9840424;-7348968;-1764752;-18954144;-20470475,52;0;0;15/03/2024
10/03/2024;EVN-YM;EVN-YM;2346021347;YM 472E28.6;-7620;-3180;-1180;-11980;-12717780;-9835740;-1279120;-23832640;-25739251,2;0;0;15/03/2024
10/03/2024;EVN-YM;EVN-YM;3001347;YM 472E28.6;-26460;-3060;-3780;-33300;-43341480;-9284040;-4021920;-56647440;-61179235,2;0;0;15/03/2024
10/03/2024;KCNTH-002;TH-Asahi;2210575757;TH486 E11.9;20034;8160;3744;31938;36241506;27042240;4432896;67716642;67716642;0;0;15/03/2024
10/03/2024;KCNYM-001;YM-VNC;2310396107;YM 472E28.6;26460;3060;3780;33300;44161740;9464580;4097520;57723840;62341747,2;0;0;15/03/2024
10/03/2024;KCNYM-002;YM-Thịnh Vượng;2310396110;YM 472E28.6;83;38;83;204;150147;125932;98272;374351;404299,08;0;0;25/03/2024
10/03/2024;KCNYM-002;YM-Thịnh Vượng;2310396111;YM 472E28.6;459;189;117;765;830331;626346;138528;1595205;1722821,4;0;0;25/03/2024
10/03/2024;KCNYM-004;YM-MQ-IDS;2310396106;YM 472E28.6;4820;2704;728;8252;8719380;8961056;861952;18542388;20025779,04;0;0;25/03/2024
10/03/2024;KCNTH-003;TH-Hợp Lực;2310396109;TH476 E11.9;5866;2390;1596;9852;10611594;7920460;1889664;20421718;22055455,44;0;0;15/03/2024
20/03/2024;EVN-TH;EVN-TH;2046008580;TH486 E11.9;-21327;-8364;-5018;-34709;-35594763;-25869852;-5439512;-66904127;-72256457,16;0;0;25/03/2024
20/03/2024;EVN-TH;EVN-TH;2046008583;TH484 E11.9;0;0;0;0;0;0;0;0;0;0;0;25/03/2024
20/03/2024;EVN-TH;EVN-TH;2110155910;TH476 E11.9;-4884;-1804;-1496;-8184;-8151396;-5579772;-1621664;-15352832;-16581058,56;0;0;25/03/2024
20/03/2024;EVN-YM;EVN-YM;2346021347;YM 472E28.6;-6690;-3000;0;-9690;-11165610;-9279000;0;-20444610;-22080178,8;0;0;25/03/2024
20/03/2024;EVN-YM;EVN-YM;3001347;YM 472E28.6;-28350;-3240;-4860;-36450;-46437300;-9830160;-5171040;-61438500;-66353580;0;0;25/03/2024
20/03/2024;KCNTH-002;TH-Asahi;2210575757;TH486 E11.9;18000;6834;3522;28356;32562000;22647876;4170048;59379924;59379924;0;0;25/03/2024
20/03/2024;KCNYM-001;YM-VNC;2310396107;YM 472E28.6;28350;3240;4860;36450;47316150;10021320;5268240;62605710;67614166,8;0;0;05/04/2024
20/03/2024;KCNYM-004;YM-MQ-IDS;2310396106;YM 472E28.6;6164;2552;808;9524;11150676;8457328;956672;20564676;22209850,08;0;0;05/04/2024
20/03/2024;KCNTH-003;TH-Hợp Lực;2310396109;TH476 E11.9;4756;1747;1429;7932;8603604;5789558;1691936;16085098;17371905,84;0;0;05/04/2024
31/03/2024;EVN-PĐ;EVN-PĐ;21041898;PĐ472;-13520;-4440;-1520;-19480;-22145760;-13470960;-1617280;-37234000;-40212720;0;0;05/04/2024
31/03/2024;EVN-TH;EVN-TH;2046008580;TH486 E11.9;-28018;-10873;-5436;-44327;-46762042;-33630189;-5892624;-86284855;-93187643,4;0;0;05/04/2024
31/03/2024;EVN-TH;EVN-TH;2046008583;TH484 E11.9;0;0;0;0;0;0;0;0;0;0;0;05/04/2024
31/03/2024;EVN-TH;EVN-TH;2110155910;TH476 E11.9;-5412;-2112;-1540;-9064;-9032628;-6532416;-1669360;-17234404;-18613156,32;0;0;05/04/2024
31/03/2024;EVN-YM;EVN-YM;2346021347;YM 472E28.6;-11156;-5442;-6360;-22958;-18619364;-16832106;-6894240;-42345710;-45733366,8;0;0;05/04/2024
31/03/2024;EVN-YM;EVN-YM;3001347;YM 472E28.6;-30780;-4110;-5160;-40050;-50417640;-12469740;-5490240;-68377620;-73847829,6;0;0;05/04/2024
31/03/2024;KCNPĐ-001;PĐ-BQL;2310231609;PĐ472;30;46;0;76;54270;152444;0;206714;223251,12;0;0;05/04/2024
31/03/2024;KCNPĐ-001;PĐ-BQL;2310231610;PĐ472;0;0;0;0;0;0;0;0;0;0;0;05/04/2024
31/03/2024;KCNPĐ-002;PĐ-AMP;2310231611;PĐ472;13032;4308;1452;18792;23574888;14276712;1719168;39570768;42736429,44;0;0;05/04/2024
31/03/2024;KCNTH-001;TH-BQL;2210575660;TH486 E11.9;2713;1397;1481;5591;4907817;4629658;1753504;11290979;12194257,32;0;0;05/04/2024
31/03/2024;KCNTH-001;TH-BQL;2310068751;TH476 E11.9;0;0;0;0;0;0;0;0;0;0;0;05/04/2024
31/03/2024;KCNTH-001;TH-BQL;2310396108;TH486 E11.9;4796;1832;1429;8057;8675964;6071248;1691936;16439148;17754279,84;0;0;05/04/2024
31/03/2024;KCNTH-002;TH-Asahi;2210575757;TH486 E11.9;24708;9636;4152;38496;44696772;31933704;4915968;81546444;81546444;0;0;05/04/2024
31/03/2024;KCNTH-004;TH-HANA;2410131385;TH486 E11.9;0;0;0;0;0;0;0;0;0;0;0;05/04/2024
31/03/2024;KCNYM-001;YM-VNC;2310396107;YM 472E28.6;30780;4110;5160;40050;51371820;12712230;5593440;69677490;75251689,2;0;0;05/04/2024
31/03/2024;KCNYM-002;YM-Thịnh Vượng;2310396110;YM 472E28.6;174;90;174;438;314766;298260;206016;819042;884565,36;0;0;11/04/2024
31/03/2024;KCNYM-002;YM-Thịnh Vượng;2310396111;YM 472E28.6;1182;445;387;2014;2138238;1474730;458208;4071176;4396870,08;0;0;14/04/2024
31/03/2024;KCNYM-004;YM-MQ-IDS;2310396106;YM 472E28.6;11676;5212;1628;18516;21121884;17272568;1927552;40322004;43547764,32;0;0;15/04/2024
31/03/2024;KCNTH-003;TH-Hợp Lực;2310396109;TH476 E11.9;5452;2128;1549;9129;9862668;7052192;1834016;18748876;20248786,08;0;0;05/04/2024
06/04/2024;KCNYM-003;YM-Jili;2310396105;YM 472E28.6;0;0;0;0;0;0;0;0;0;0;0;15/04/2024
09/04/2024;KCNTH-005;TH-FTA;2410131539;TH486 E11.9;0;0;0;0;0;0;0;0;0;0;0;15/04/2024
10/04/2024;EVN-TH;EVN-TH;2046008580;TH486 E11.9;-37218;-12545;-11709;-61472;-62116842;-38801685;-12692556;-113611083;-122699969,6;0;0;15/04/2024
10/04/2024;EVN-TH;EVN-TH;2046008583;TH484 E11.9;0;0;0;0;0;0;0;0;0;0;0;15/04/2024
10/04/2024;EVN-TH;EVN-TH;2110155910;TH476 E11.9;-5060;-1672;-1540;-8272;-8445140;-5171496;-1669360;-15285996;-16508875,68;0;0;15/04/2024
10/04/2024;EVN-YM;EVN-YM;2346021347;YM 472E28.6;-20576;-7986;-5246;-33808;-34341344;-24700698;-5686664;-64728706;-69907002,48;0;0;15/04/2024
10/04/2024;EVN-YM;EVN-YM;3001347;YM 472E28.6;-18720;-3150;-2850;-24720;-30663360;-9557100;-3032400;-43252860;-46713088,8;0;0;15/04/2024
10/04/2024;KCNTH-002;TH-Asahi;2210575757;TH486 E11.9;33126;10908;10800;54834;59924934;36149112;12787200;108861246;108861246;0;0;15/04/2024
10/04/2024;KCNYM-001;YM-VNC;2310396107;YM 472E28.6;18720;3150;2850;24720;31243680;9742950;3089400;44076030;47602112,4;0;0;16/04/2024
10/04/2024;KCNYM-003;YM-Jili;2310396105;YM 472E28.6;250;67;102;419;452250;222038;120768;795056;858660,48;0;0;25/04/2024
10/04/2024;KCNTH-003;TH-Hợp Lực;2310396109;TH476 E11.9;4978;1654;1526;8158;9005202;5481356;1806784;16293342;17596809,36;0;0;16/04/2024
11/04/2024;KCNTH-001;TH-BQL;2310396104;TH476 E11.9;0;0;0;0;0;0;0;0;0;0;0;25/04/2024
11/04/2024;KCNTH-001;TH-BQL;2310068751;TH476 E11.9;3;0;0;3;5427;0;0;5427;5861,16;0;0;25/04/2024
20/04/2024;EVN-TH;EVN-TH;2046008580;TH486 E11.9;-46000;-17145;-15055;-78200;-76774000;-53029485;-16319620;-146123105;-157812953,4;0;0;25/04/2024
20/04/2024;EVN-TH;EVN-TH;2046008583;TH484 E11.9;0;0;0;0;0;0;0;0;0;0;0;25/04/2024
20/04/2024;EVN-TH;EVN-TH;2110155910;TH476 E11.9;-4708;-1848;-1628;-8184;-7857652;-5715864;-1764752;-15338268;-16565329,44;0;0;25/04/2024
20/04/2024;EVN-YM;EVN-YM;2346021347;YM 472E28.6;-18830;-8136;-8710;-35676;-31427270;-25164648;-9441640;-66033558;-71316242,64;0;0;25/04/2024
20/04/2024;EVN-YM;EVN-YM;3001347;YM 472E28.6;-19410;-3000;-3210;-25620;-31793580;-9102000;-3415440;-44311020;-47855901,6;0;0;25/04/2024
20/04/2024;KCNTH-002;TH-Asahi;2210575757;TH486 E11.9;42066;15252;13848;71166;76097394;50545128;16396032;143038554;143038554;0;0;05/05/2024
20/04/2024;KCNYM-001;YM-VNC;2310396107;YM 472E28.6;19410;3000;3210;25620;32395290;9279000;3479640;45153930;48766244,4;0;0;05/05/2024
20/04/2024;KCNTH-003;TH-Hợp Lực;2310396109;TH476 E11.9;4699;1796;1598;8093;8500491;5951944;1892032;16344467;17652024,36;0;0;05/05/2024
30/04/2024;EVN-PĐ;EVN-PĐ;21041898;PĐ472;-17720;-6040;-2200;-25960;-29025360;-18325360;-2340800;-49691520;-53666841,6;0;0;05/05/2024
30/04/2024;EVN-TH;EVN-TH;2046008580;TH486 E11.9;-43491;-13800;-13800;-71091;-72586479;-42683400;-14959200;-130229079;-140647405,3;0;0;05/05/2024
30/04/2024;EVN-TH;EVN-TH;2046008583;TH484 E11.9;0;0;0;0;0;0;0;0;0;0;0;05/05/2024
30/04/2024;EVN-TH;EVN-TH;2110155910;TH476 E11.9;-5412;-1804;-1540;-8756;-9032628;-5579772;-1669360;-16281760;-17584300,8;0;0;05/05/2024
30/04/2024;EVN-YM;EVN-YM;2346021347;YM 472E28.6;-19608;-6776;-6892;-33276;-32725752;-20958168;-7470928;-61154848;-66047235,84;0;0;05/05/2024
30/04/2024;EVN-YM;EVN-YM;3001347;YM 472E28.6;-15960;-2760;-2340;-21060;-26142480;-8373840;-2489760;-37006080;-39966566,4;0;0;05/05/2024
30/04/2024;KCNPĐ-002;PĐ-AMP;2310231611;PĐ472;17587;6010;2136;25733;31814883;19917140;2529024;54261047;58601930,76;0;0;05/05/2024
30/04/2024;KCNTH-001;TH-BQL;2210575660;TH486 E11.9;3652;1675;1752;7079;6606468;5550950;2074368;14231786;15370328,88;0;0;05/05/2024
30/04/2024;KCNTH-001;TH-BQL;2310396108;TH486 E11.9;6686;2050;1467;10203;12094974;6793700;1736928;20625602;22275650,16;0;0;05/05/2024
30/04/2024;KCNTH-001;TH-BQL;2310396104;TH476 E11.9;0;0;0;0;0;0;0;0;0;0;0;05/05/2024
30/04/2024;KCNTH-002;TH-Asahi;2210575757;TH486 E11.9;37440;12468;11760;61668;67728960;41318952;13923840;122971752;122971752;0;0;05/05/2024
30/04/2024;KCNTH-004;TH-HANA;2410131385;TH486 E11.9;467;164;230;861;844803;543496;272320;1660619;1793468,52;0;0;05/05/2024
30/04/2024;KCNTH-005;TH-FTA;2410131539;TH486 E11.9;322;74;41;437;582498;245236;48544;876278;946380,24;0;0;05/05/2024
30/04/2024;KCNYM-001;YM-VNC;2310396107;YM 472E28.6;15960;2760;2340;21060;26637240;8536680;2536560;37710480;40727318,4;0;0;05/05/2024
30/04/2024;KCNYM-002;YM-Thịnh Vượng;2310396110;YM 472E28.6;510;181;317;1008;922590;599834;375328;1897752;2049572,16;0;0;05/05/2024
30/04/2024;KCNYM-002;YM-Thịnh Vượng;2310396111;YM 472E28.6;1392;499;651;2542;2518128;1653686;770784;4942598;5338005,84;0;0;15/05/2024
30/04/2024;KCNYM-003;YM-Jili;2310396105;YM 472E28.6;1034;325;461;1820;1870506;1077050;545824;3493380;3772850,4;0;0;15/05/2024
30/04/2024;KCNYM-004;YM-MQ-IDS;2310396106;YM 472E28.6;54348;21312;18696;94356;98315532;70627968;22136064;191079564;206365929,1;0;0;15/05/2024
30/04/2024;KCNTH-003;TH-Hợp Lực;2310396109;TH476 E11.9;5292;1814;1519;8625;9573228;6011596;1798496;17383320;18773985,6;0;0;05/05/2024
10/05/2024;EVN-TH;EVN-TH;2046008580;TH486 E11.9;-21327;-8782;-7109;-37218;-35594763;-27162726;-7706156;-70463645;-76100736,6;0;0;15/05/2024
10/05/2024;EVN-TH;EVN-TH;2046008583;TH484 E11.9;0;0;0;0;0;0;0;0;0;0;0;15/05/2024
10/05/2024;EVN-TH;EVN-TH;2110155910;TH476 E11.9;-4180;-1628;-1320;-7128;-6976420;-5035404;-1430880;-13442704;-14518120,32;0;0;15/05/2024
10/05/2024;EVN-YM;EVN-YM;2346021347;YM 472E28.6;-16106;-6208;-6248;-28562;-26880914;-19201344;-6772832;-52855090;-57083497,2;0;0;15/05/2024
10/05/2024;EVN-YM;EVN-YM;3001347;YM 472E28.6;-17190;-2640;-3000;-22830;-28157220;-8009760;-3192000;-39358980;-42507698,4;0;0;15/05/2024
10/05/2024;KCNTH-002;TH-Asahi;2210575757;TH486 E11.9;17220;6816;5442;29478;31150980;22588224;6443328;60182532;60182532;0;0;20/05/2024
10/05/2024;KCNYM-001;YM-VNC;2310396107;YM 472E28.6;17190;2640;3000;22830;28690110;8165520;3252000;40107630;43316240,4;0;0;25/05/2024
10/05/2024;KCNTH-003;TH-Hợp Lực;2310396109;TH476 E11.9;4160;1639;1289;7088;7525440;5431646;1526176;14483262;15641922,96;0;0;25/05/2024
15/05/2024;KCNYM-004;YM-MQ-IDS;2310396106;YM 472E28.6;25312;9540;8684;43536;45789408;31615560;10281856;87686824;94701769,92;0;0;25/05/2024
20/05/2024;EVN-TH;EVN-TH;2046008580;TH486 E11.9;-45164;-15055;-13382;-73601;-75378716;-46565115;-14506088;-136449919;-147365912,5;0;0;25/05/2024
20/05/2024;EVN-TH;EVN-TH;2046008583;TH484 E11.9;0;0;0;0;0;0;0;0;0;0;0;25/05/2024
20/05/2024;EVN-TH;EVN-TH;2110155910;TH476 E11.9;-5280;-1804;-1320;-8404;-8812320;-5579772;-1430880;-15822972;-17088809,76;0;0;25/05/2024
20/05/2024;EVN-YM;EVN-YM;2346021347;YM 472E28.6;-22294;-8354;-7582;-38230;-37208686;-25838922;-8218888;-71266496;-76967815,68;0;0;25/05/2024
20/05/2024;EVN-YM;EVN-YM;3001347;YM 472E28.6;-13290;-3150;-4050;-20490;-21769020;-9557100;-4309200;-35635320;-38486145,6;0;0;25/05/2024
20/05/2024;KCNTH-002;TH-Asahi;2210575757;TH486 E11.9;39396;13050;11466;63912;71267364;43247700;13575744;128090808;128090808;0;0;05/06/2024
20/05/2024;KCNYM-001;YM-VNC;2310396107;YM 472E28.6;13290;3150;4050;20490;22181010;9742950;4390200;36314160;39219292,8;0;0;05/06/2024
20/05/2024;KCNTH-003;TH-Hợp Lực;2310396109;TH476 E11.9;5317;1750;1324;8391;9618453;5799500;1567616;16985569;18344414,52;0;0;05/06/2024
31/05/2024;EVN-PĐ;EVN-PĐ;21041898;PĐ472;-21360;-7120;-1840;-30320;-34987680;-21602080;-1957760;-58547520;-63231321,6;0;0;05/06/2024
31/05/2024;EVN-TH;EVN-TH;2046008580;TH486 E11.9;-51018;-20073;-15055;-86146;-85149042;-62085789;-16319620;-163554451;-176638807,1;0;0;05/06/2024
31/05/2024;EVN-TH;EVN-TH;2046008583;TH484 E11.9;0;0;0;0;0;0;0;0;0;0;0;05/06/2024
31/05/2024;EVN-TH;EVN-TH;2110155910;TH476 E11.9;-5412;-2112;-1540;-9064;-9032628;-6532416;-1669360;-17234404;-18613156,32;0;0;05/06/2024
31/05/2024;EVN-YM;EVN-YM;2346021347;YM 472E28.6;-23962;-10428;-9630;-44020;-39992578;-32253804;-10438920;-82685302;-89300126,16;0;0;05/06/2024
31/05/2024;EVN-YM;EVN-YM;3001347;YM 472E28.6;-32550;-4260;-4530;-41340;-53316900;-12924840;-4819920;-71061660;-76746592,8;0;0;05/06/2024
31/05/2024;KCNPĐ-001;PĐ-BQL;2310231609;PĐ472;1;0;0;1;1809;0;0;1809;1953,72;0;0;05/06/2024
31/05/2024;KCNPĐ-001;PĐ-BQL;2310231610;PĐ472;0;0;0;0;0;0;0;0;0;0;0;05/06/2024
31/05/2024;KCNPĐ-002;PĐ-AMP;2310231611;PĐ472;21218;7078;1802;30098;38383362;23456492;2133568;63973422;69091295,76;0;0;05/06/2024
31/05/2024;KCNTH-001;TH-BQL;2210575660;TH486 E11.9;5207;2249;2024;9480;9419463;7453186;2396416;19269065;20810590,2;0;0;05/06/2024
31/05/2024;KCNTH-001;TH-BQL;2310396104;TH476 E11.9;0;0;0;0;0;0;0;0;0;0;0;05/06/2024
31/05/2024;KCNTH-001;TH-BQL;2310396108;TH486 E11.9;5447;1916;1400;8763;9853623;6349624;1657600;17860847;19289714,76;0;0;05/06/2024
31/05/2024;KCNTH-002;TH-Asahi;2210575757;TH486 E11.9;43800;17658;13134;74592;79234200;58518612;15550656;153303468;153303468;0;0;05/06/2024
31/05/2024;KCNTH-004;TH-HANA;2410131385;TH486 E11.9;1606;552;525;2683;2905254;1829328;621600;5356182;5784676,56;0;0;05/06/2024
31/05/2024;KCNTH-005;TH-FTA;2410131539;TH486 E11.9;2763;926;847;4536;4998267;3068764;1002848;9069879;9795469,32;0;0;05/06/2024
31/05/2024;KCNYM-001;YM-VNC;2310396107;YM 472E28.6;32550;4260;4530;41340;54325950;13176180;4910520;72412650;78205662;0;0;05/06/2024
31/05/2024;KCNYM-002;YM-Thịnh Vượng;2310396110;YM 472E28.6;1654;603;750;3007;2992086;1998342;888000;5878428;6348702,24;0;0;05/06/2024
31/05/2024;KCNYM-002;YM-Thịnh Vượng;2310396111;YM 472E28.6;365;136;134;635;660285;450704;158656;1269645;1371216,6;0;0;10/06/2024
31/05/2024;KCNYM-003;YM-Jili;2310396105;YM 472E28.6;3272;1085;1434;5791;5919048;3595690;1697856;11212594;12109601,52;0;0;15/06/2024
31/05/2024;KCNYM-004;YM-MQ-IDS;2310396106;YM 472E28.6;30432;13068;11804;55304;55051488;43307352;13975936;112334776;121321558,1;0;0;15/06/2024
31/05/2024;KCNTH-003;TH-Hợp Lực;2310396109;TH476 E11.9;5390;2134;1502;9026;9750510;7072076;1778368;18600954;20089030,32;0;0;05/06/2024
05/06/2024;KCNTH-006;TH-Giza;2410131376;TH486 E11.9;0;0;0;0;0;0;0;0;0;0;0;15/06/2024
10/06/2024;EVN-TH;EVN-TH;2046008580;TH486 E11.9;-44745;-15055;-13800;-73600;-74679405;-46565115;-14959200;-136203720;-147100017,6;0;0;15/06/2024
10/06/2024;EVN-TH;EVN-TH;2046008583;TH484 E11.9;0;0;0;0;0;0;0;0;0;0;0;15/06/2024
10/06/2024;EVN-TH;EVN-TH;2110155910;TH476 E11.9;-4268;-1496;-1364;-7128;-7123292;-4627128;-1478576;-13228996;-14287315,68;0;0;15/06/2024
10/06/2024;EVN-YM;EVN-YM;2346021347;YM 472E28.6;-28330;-10386;-3526;-42242;-47282770;-32123898;-3822184;-83228852;-89887160,16;0;0;15/06/2024
10/06/2024;EVN-YM;EVN-YM;3001347;YM 472E28.6;-14790;-3150;-5130;-23070;-24226020;-9557100;-5458320;-39241440;-42380755,2;0;0;15/06/2024
10/06/2024;KCNTH-002;TH-Asahi;2210575757;TH486 E11.9;37332;12408;11688;61428;67533588;41120112;13838592;122492292;122492292;0;0;20/06/2024
10/06/2024;KCNYM-001;YM-VNC;2310396107;YM 472E28.6;14790;3150;5130;23070;24684510;9742950;5560920;39988380;43187450,4;0;0;25/06/2024
10/06/2024;KCNTH-003;TH-Hợp Lực;2310396109;TH476 E11.9;4259;1478;1355;7092;7704531;4898092;1604320;14206943;15343498,44;0;0;25/06/2024
15/06/2024;KCNYM-004;YM-MQ-IDS;2310396106;YM 472E28.6;28952;12716;4476;46144;52374168;42140824;5299584;99814576;107799742,1;0;0;25/06/2024
20/06/2024;EVN-TH;EVN-TH;2046008580;TH486 E11.9;-51018;-18400;-15891;-85309;-85149042;-56911200;-17225844;-159286086;-172028972,9;0;0;25/06/2024
20/06/2024;EVN-TH;EVN-TH;2046008583;TH484 E11.9;0;0;0;0;0;0;0;0;0;0;0;25/06/2024
20/06/2024;EVN-TH;EVN-TH;2110155910;TH476 E11.9;-4312;-1804;-1496;-7612;-7196728;-5579772;-1621664;-14398164;-15550017,12;0;0;25/06/2024
20/06/2024;EVN-YM;EVN-YM;2346021347;YM 472E28.6;-46572;-18790;-5714;-71076;-77728668;-58117470;-6193976;-142040114;-153403323,1;0;0;25/06/2024
20/06/2024;EVN-YM;EVN-YM;3001347;YM 472E28.6;-21540;-3450;-4590;-29580;-35282520;-10467300;-4883760;-50633580;-54684266,4;0;0;25/06/2024
20/06/2024;KCNTH-002;TH-Asahi;2210575757;TH486 E11.9;42126;15120;13152;70398;76205934;50107680;15571968;141885582;141885582;0;0;28/06/2024
20/06/2024;KCNYM-001;YM-VNC;2310396107;YM 472E28.6;21540;3450;4590;29580;35950260;10670850;4975560;51596670;55724403,6;0;0;05/07/2024
20/06/2024;KCNTH-003;TH-Hợp Lực;2310396109;TH476 E11.9;4276;1769;1498;7543;7735284;5862466;1773632;15371382;16601092,56;0;0;05/07/2024
23/06/2024;KCNTH-007;TH-Sinher;2410131383;TH486 E11.9;0;0;0;0;0;0;0;0;0;0;0;05/07/2024
30/06/2024;EVN-PĐ;EVN-PĐ;21041898;PĐ472;-25680;-8600;-1960;-36240;-42063840;-26092400;-2085440;-70241680;-75861014,4;0;0;05/07/2024
30/06/2024;EVN-TH;EVN-TH;2046008580;TH486 E11.9;-48509;-18818;-15055;-82382;-80961521;-58204074;-16319620;-155485215;-167924032,2;0;0;05/07/2024
30/06/2024;EVN-TH;EVN-TH;2046008583;TH484 E11.9;0;0;0;0;0;0;0;0;0;0;0;05/07/2024
30/06/2024;EVN-TH;EVN-TH;2110155910;TH476 E11.9;-3652;-1452;-1320;-6424;-6095188;-4491036;-1430880;-12017104;-12978472,32;0;0;05/07/2024
30/06/2024;EVN-YM;EVN-YM;2346021347;YM 472E28.6;-49078;-19898;-7146;-76122;-81911182;-61544514;-7746264;-151201960;-163298116,8;0;0;05/07/2024
30/06/2024;EVN-YM;EVN-YM;3001347;YM 472E28.6;-16410;-3030;-2070;-21510;-26879580;-9193020;-2202480;-38275080;-41337086,4;0;0;05/07/2024
30/06/2024;KCNPĐ-001;PĐ-BQL;2310231609;PĐ472;421;195;238;854;761589;646230;281792;1689611;1824779,88;0;0;05/07/2024
30/06/2024;KCNPĐ-001;PĐ-BQL;2310231610;PĐ472;0;0;0;0;0;0;0;0;0;0;0;05/07/2024
30/06/2024;KCNPĐ-002;PĐ-AMP;2310231611;PĐ472;24818;8354;1663;34835;44895762;27685156;1968992;74549910;80513902,8;0;0;05/07/2024
30/06/2024;KCNTH-001;TH-BQL;2210575660;TH486 E11.9;6242;2683;2239;11164;11291778;8891462;2650976;22834216;24660953,28;0;0;05/07/2024
30/06/2024;KCNTH-001;TH-BQL;2310396104;TH476 E11.9;0;0;0;0;0;0;0;0;0;0;0;05/07/2024
30/06/2024;KCNTH-001;TH-BQL;2310396108;TH486 E11.9;5620;2072;1184;8876;10166580;6866608;1401856;18435044;19909847,52;0;0;05/07/2024
30/06/2024;KCNTH-002;TH-Asahi;2210575757;TH486 E11.9;39540;14916;12036;66492;71527860;49431624;14250624;135210108;135210108;0;0;05/07/2024
30/06/2024;KCNTH-004;TH-HANA;2410131385;TH486 E11.9;2031;731;669;3431;3674079;2422534;792096;6888709;7439805,72;0;0;05/07/2024
30/06/2024;KCNTH-005;TH-FTA;2410131539;TH486 E11.9;3411;1276;1470;6157;6170499;4228664;1740480;12139643;13110814,44;0;0;05/07/2024
30/06/2024;KCNTH-006;TH-Giza;2410131376;TH486 E11.9;3472;1218;1074;5764;6280848;4036452;1271616;11588916;12516029,28;0;0;05/07/2024
30/06/2024;KCNTH-007;TH-Sinher;2410131383;TH486 E11.9;1328;624;196;2148;2402352;2067936;232064;4702352;4702352;0;0;05/07/2024
30/06/2024;KCNYM-001;YM-VNC;2310396107;YM 472E28.6;16410;3030;2070;21510;27388290;9371790;2243880;39003960;42124276,8;0;0;05/07/2024
30/06/2024;KCNYM-002;YM-Thịnh Vượng;2310396110;YM 472E28.6;4339;1493;954;6786;7849251;4947802;1129536;13926589;15040716,12;0;0;05/07/2024
30/06/2024;KCNYM-002;YM-Thịnh Vượng;2310396111;YM 472E28.6;584;210;219;1013;1056456;695940;259296;2011692;2172627,36;0;0;09/07/2024
30/06/2024;KCNYM-003;YM-Jili;2310396105;YM 472E28.6;59130;21166;3126;83422;106966170;70144124;3701184;180811478;195276396,2;0;0;15/07/2024
30/06/2024;KCNYM-004;YM-MQ-IDS;2310396106;YM 472E28.6;28836;12772;7060;48668;52164324;42326408;8359040;102849772;111077753,8;0;0;15/07/2024
30/06/2024;KCNTH-003;TH-Hợp Lực;2310396109;TH476 E11.9;3589;1469;1348;6406;6492501;4868266;1596032;12956799;13993342,92;0;0;05/07/2024
04/07/2024;EVN-TH;EVN-TH;2046008580;TH486 E11.9;-24255;-7831;-7945;-40031;-40481595;-24221283;-8612380;-73315258;-79180478,64;0;0;15/07/2024
10/07/2024;EVN-TH;EVN-TH;2046008580;TH486 E11.9;-30527;-10036;-8782;-49345;-50949563;-31041348;-9519688;-91510599;-98831446,92;0;0;15/07/2024
10/07/2024;EVN-TH;EVN-TH;2046008583;TH484 E11.9;0;0;0;0;0;0;0;0;0;0;0;15/07/2024
10/07/2024;EVN-TH;EVN-TH;2110155910;TH476 E11.9;-4092;-1408;-1452;-6952;-6829548;-4354944;-1573968;-12758460;-13779136,8;0;0;15/07/2024
10/07/2024;EVN-YM;EVN-YM;3001347;YM 472E28.6;-16590;-3210;-3240;-23040;-27174420;-9739140;-3447360;-40360920;-43589793,6;0;0;15/07/2024
10/07/2024;EVN-YM;EVN-YM;2346021347;YM 472E28.6;-50450;-18230;-9144;-77824;-84201050;-56385390;-9912096;-150498536;-162538418,9;0;0;20/07/2024
10/07/2024;KCNTH-002;TH-Asahi;2210575757;TH486 E11.9;45336;14952;13998;74286;82012824;49550928;16573632;148137384;148137384;0;0;20/07/2024
10/07/2024;KCNTH-003;TH-Hợp Lực;2310396109;TH476 E11.9;4080;1393;1450;6923;7380720;4616402;1716800;13713922;14811035,76;0;0;20/07/2024
15/07/2024;KCNYM-001;YM-VNC;2310396107;YM 472E28.6;26670;4860;4770;36300;44512230;15031980;5170680;64714890;69892081,2;0;0;25/07/2024
15/07/2024;KCNYM-003;YM-Jili;2310396105;YM 472E28.6;42133;14554;2086;58773;76218597;48231956;2469824;126920377;137074007,2;0;0;25/07/2024
15/07/2024;KCNYM-004;YM-MQ-IDS;2310396106;YM 472E28.6;32364;12436;11088;55888;58546476;41212904;13128192;112887572;121918577,8;0;0;25/07/2024
20/07/2024;EVN-TH;EVN-TH;2046008580;TH486 E11.9;-52273;-19236;-16727;-88236;-87243637;-59496948;-18132068;-164872653;-178062465,2;0;0;25/07/2024
20/07/2024;EVN-TH;EVN-TH;2046008583;TH484 E11.9;0;0;0;0;0;0;0;0;0;0;0;25/07/2024
20/07/2024;EVN-TH;EVN-TH;2110155910;TH476 E11.9;-3696;-1496;-1540;-6732;-6168624;-4627128;-1669360;-12465112;-13462320,96;0;0;25/07/2024
20/07/2024;EVN-YM;EVN-YM;3001347;YM 472E28.6;-23520;-4260;-3660;-31440;-38525760;-12924840;-3894240;-55344840;-59772427,2;0;0;25/07/2024
20/07/2024;EVN-YM;EVN-YM;2346021347;YM 472E28.6;-49120;-19660;-8532;-77312;-81981280;-60808380;-9248688;-152038348;-164201415,8;0;0;29/07/2024
20/07/2024;KCNTH-002;TH-Asahi;2210575757;TH486 E11.9;43062;15648;13248;71958;77899158;51857472;15685632;145442262;145442262;0;0;01/08/2024
20/07/2024;KCNTH-003;TH-Hợp Lực;2310396109;TH476 E11.9;3707;1501;1478;6686;6705963;4974314;1749952;13430229;14504647,32;0;0;01/08/2024
24/07/2024;KCNTH-009A;TH-Hợp Nhất;2410131547;TH486 E11.9;0;0;0;0;0;0;0;0;0;0;0;05/08/2024
27/07/2024;EVN-03;EVN-03;2246014403;AT479 E28.24;0;0;0;0;0;0;0;0;0;0;0;05/08/2024
27/07/2024;EVN-03;EVN-03;2246014464;AT481 E28.24;0;0;0;0;0;0;0;0;0;0;0;05/08/2024
31/07/2024;EVN-PĐ;EVN-PĐ;21041898;PĐ472;-26680;-8800;-2200;-37680;-43701840;-26699200;-2340800;-72741840;-78561187,2;0;0;05/08/2024
31/07/2024;EVN-TH;EVN-TH;2046008580;TH486 E11.9;-38473;-12545;-11709;-62727;-64211437;-38801685;-12692556;-115705678;-124962132,2;0;0;05/08/2024
31/07/2024;EVN-TH;EVN-TH;2046008583;TH484 E11.9;0;0;0;0;0;0;0;0;0;0;0;05/08/2024
31/07/2024;EVN-TH;EVN-TH;2110155910;TH476 E11.9;-3872;-1276;-1672;-6820;-6462368;-3946668;-1812448;-12221484;-13199202,72;0;0;05/08/2024
31/07/2024;EVN-YM;EVN-YM;2346021347;YM 472E28.6;-50674;-18190;-7094;-75958;-84574906;-56261670;-7689896;-148526472;-160408589,8;0;0;05/08/2024
31/07/2024;EVN-YM;EVN-YM;3001347;YM 472E28.6;-19950;-3330;-7770;-31050;-32678100;-10103220;-8267280;-51048600;-55132488;0;0;05/08/2024
31/07/2024;KCNPĐ-001;PĐ-BQL;2310231609;PĐ472;711;237;398;1346;1286199;785418;471232;2542849;2746276,92;0;0;05/08/2024
31/07/2024;KCNPĐ-001;PĐ-BQL;2310231610;PĐ472;0;0;0;0;0;0;0;0;0;0;0;05/08/2024
31/07/2024;KCNPĐ-002;PĐ-AMP;2310231611;PĐ472;25730;8546;1790;36066;46545570;28321444;2119360;76986374;83145283,92;0;0;05/08/2024
31/07/2024;KCNTH-001;TH-BQL;2210575660;TH486 E11.9;6606;2746;2419;11771;11950254;9100244;2864096;23914594;25827761,52;0;0;05/08/2024
31/07/2024;KCNTH-001;TH-BQL;2310396104;TH476 E11.9;0;0;0;0;0;0;0;0;0;0;0;05/08/2024
31/07/2024;KCNTH-001;TH-BQL;2310396108;TH486 E11.9;705;361;581;1647;1275345;1196354;687904;3159603;3412371,24;0;0;05/08/2024
31/07/2024;KCNTH-002;TH-Asahi;2210575757;TH486 E11.9;28938;9300;7968;46206;52348842;30820200;9434112;92603154;92603154;0;0;05/08/2024
31/07/2024;KCNTH-004;TH-HANA;2410131385;TH486 E11.9;2484;841;692;4017;4493556;2787074;819328;8099958;8747954,64;0;0;05/08/2024
31/07/2024;KCNTH-005;TH-FTA;2410131539;TH486 E11.9;4410;1584;1577;7571;7977690;5249376;1867168;15094234;16301772,72;0;0;05/08/2024
31/07/2024;KCNTH-006;TH-Giza;2410131376;TH486 E11.9;4594;1555;1434;7583;8310546;5153270;1697856;15161672;16374605,76;0;0;05/08/2024
31/07/2024;KCNTH-007;TH-Sinher;2410131383;TH486 E11.9;5804;1688;1288;8780;10499436;5594032;1524992;17618460;17618460;0;0;05/08/2024
31/07/2024;KCNYM-001;YM-VNC;2310396107;YM 472E28.6;33390;5940;9900;49230;55727910;18372420;10731600;84831930;91618484,4;0;0;05/08/2024
31/07/2024;KCNYM-002;YM-Thịnh Vượng;2310396110;YM 472E28.6;4958;1744;1418;8120;8969022;5779616;1678912;16427550;17741754;0;0;05/08/2024
31/07/2024;KCNYM-002;YM-Thịnh Vượng;2310396111;YM 472E28.6;320;91;48;459;578880;301574;56832;937286;1012268,88;0;0;15/08/2024
31/07/2024;KCNYM-003;YM-Jili;2310396105;YM 472E28.6;41635;14926;3021;59582;75317715;49464764;3576864;128359343;138628090,4;0;0;15/08/2024
31/07/2024;KCNYM-004;YM-MQ-IDS;2310396106;YM 472E28.6;27232;11564;6452;45248;49262688;38323096;7639168;95224952;102842948,2;0;0;15/08/2024
31/07/2024;KCNTH-003;TH-Hợp Lực;2310396109;TH476 E11.9;3737;1303;1573;6613;6760233;4318142;1862432;12940807;13976071,56;0;0;05/08/2024
10/08/2024;EVN-TH;EVN-TH;2046008580;TH486 E11.9;-55618;-19655;-16727;-92000;-92826442;-60792915;-18132068;-171751425;-185491539;0;0;15/08/2024
10/08/2024;EVN-TH;EVN-TH;2046008583;TH484 E11.9;0;0;0;0;0;0;0;0;0;0;0;15/08/2024
10/08/2024;EVN-TH;EVN-TH;2110155910;TH476 E11.9;-3124;-1320;-1276;-5720;-5213956;-4082760;-1383184;-10679900;-11534292;0;0;15/08/2024
10/08/2024;EVN-YM;EVN-YM;3001347;YM 472E28.6;-16710;-3570;-5580;-25860;-27370980;-10831380;-5937120;-44139480;-47670638,4;0;0;15/08/2024
10/08/2024;EVN-YM;EVN-YM;2346021347;YM 472E28.6;-53770;-20702;-9204;-83676;-89742130;-64031286;-9977136;-163750552;-176850596,2;0;0;20/08/2024
10/08/2024;KCNTH-002;TH-Asahi;2210575757;TH486 E11.9;46776;16374;14058;77208;84617784;54263436;16644672;155525892;155525892;0;0;20/08/2024
10/08/2024;KCNTH-003;TH-Hợp Lực;2310396109;TH476 E11.9;3220;1307;1390;5917;5824980;4331398;1645760;11802138;12746309,04;0;0;20/08/2024
15/08/2024;KCNYM-001;YM-VNC;2310396107;YM 472E28.6;24990;5670;6870;37530;41708310;17537310;7447080;66692700;72028116;0;0;25/08/2024
15/08/2024;KCNYM-003;YM-Jili;2310396105;YM 472E28.6;38826;14958;6402;60186;70236234;49570812;7579968;127387014;137577975,1;0;0;25/08/2024
15/08/2024;KCNYM-004;YM-MQ-IDS;2310396106;YM 472E28.6;28568;11632;6140;46340;51679512;38548448;7269760;97497720;105297537,6;0;0;25/08/2024
20/08/2024;EVN-TH;EVN-TH;2046008580;TH486 E11.9;-55200;-17982;-17145;-90327;-92128800;-55618326;-18585180;-166332306;-179638890,5;0;0;25/08/2024
20/08/2024;EVN-TH;EVN-TH;2046008583;TH484 E11.9;0;0;0;0;0;0;0;0;0;0;0;25/08/2024
20/08/2024;EVN-TH;EVN-TH;2110155910;TH476 E11.9;-3080;-1144;-1320;-5544;-5140520;-3538392;-1430880;-10109792;-10918575,36;0;0;25/08/2024
20/08/2024;EVN-YM;EVN-YM;3001347;YM 472E28.6;-19050;-4320;-2700;-26070;-31203900;-13106880;-2872800;-47183580;-50958266,4;0;0;25/08/2024
20/08/2024;EVN-YM;EVN-YM;2346021347;YM 472E28.6;-51110;-19856;-11812;-82778;-85302590;-61414608;-12804208;-159521406;-172283118,5;0;0;05/09/2024
20/08/2024;KCNTH-002;TH-Asahi;2210575757;TH486 E11.9;44124;15000;13206;72330;79820316;49710000;15635904;145166220;145166220;0;0;05/09/2024
20/08/2024;KCNTH-003;TH-Hợp Lực;2310396109;TH476 E11.9;2995;1115;1186;5296;5417955;3695110;1404224;10517289;11358672,12;0;0;05/09/2024
31/08/2024;EVN-PĐ;EVN-PĐ;21041898;PĐ472;-28920;-9440;-2360;-40720;-47370960;-28640960;-2511040;-78522960;-84804796,8;0;0;05/09/2024
31/08/2024;EVN-TH;EVN-TH;2046008580;TH486 E11.9;-64400;-24255;-17982;-106637;-107483600;-75020715;-19492488;-201996803;-218156547,2;0;0;05/09/2024
31/08/2024;EVN-TH;EVN-TH;2046008583;TH484 E11.9;0;0;0;0;0;0;0;0;0;0;0;05/09/2024
31/08/2024;EVN-TH;EVN-TH;2110155910;TH476 E11.9;-3168;-1408;-1320;-5896;-5287392;-4354944;-1430880;-11073216;-11959073,28;0;0;05/09/2024
31/08/2024;EVN-YM;EVN-YM;3001347;YM 472E28.6;-33390;-5610;-4110;-43110;-54692820;-17020740;-4373040;-76086600;-82173528;0;0;05/09/2024
31/08/2024;EVN-YM;EVN-YM;2346021347;YM 472E28.6;-69602;-28790;-14178;-112570;-116165738;-89047470;-15368952;-220582160;-238228732,8;0;0;05/09/2024
31/08/2024;KCNPĐ-001;PĐ-BQL;2310231609;PĐ472;820;314;648;1782;1483380;1040596;767232;3291208;3554504,64;0;0;05/09/2024
31/08/2024;KCNPĐ-001;PĐ-BQL;2310231610;PĐ472;0;0;0;0;0;0;0;0;0;0;0;05/09/2024
31/08/2024;KCNPĐ-002;PĐ-AMP;2310231611;PĐ472;27590;9098;1634;38322;49910310;30150772;1934656;81995738;88555397,04;0;0;05/09/2024
31/08/2024;KCNTH-001;TH-BQL;2210575660;TH486 E11.9;6310;2588;2185;11083;11414790;8576632;2587040;22578462;24384738,96;0;0;05/09/2024
31/08/2024;KCNTH-001;TH-BQL;2310396104;TH476 E11.9;0;0;0;0;0;0;0;0;0;0;0;05/09/2024
31/08/2024;KCNTH-001;TH-BQL;2310396108;TH486 E11.9;770;424;571;1765;1392930;1405136;676064;3474130;3752060,4;0;0;05/09/2024
31/08/2024;KCNTH-002;TH-Asahi;2210575757;TH486 E11.9;48474;18228;13866;80568;87689466;60407592;16417344;164514402;164514402;0;0;05/09/2024
31/08/2024;KCNTH-004;TH-HANA;2410131385;TH486 E11.9;3236;1158;793;5187;5853924;3837612;938912;10630448;11480883,84;0;0;05/09/2024
31/08/2024;KCNTH-005;TH-FTA;2410131539;TH486 E11.9;6516;2128;2107;10751;11787444;7052192;2494688;21334324;23041069,92;0;0;05/09/2024
31/08/2024;KCNTH-006;TH-Giza;2410131376;TH486 E11.9;4594;1658;1322;7574;8310546;5494612;1565248;15370406;16600038,48;0;0;05/09/2024
31/08/2024;KCNTH-007;TH-Sinher;2410131383;TH486 E11.9;9468;3080;1908;14456;17127612;10207120;2259072;29593804;29593804;0;0;05/09/2024
31/08/2024;KCNTH-009A;TH-Hợp Nhất;2410131547;TH486 E11.9;596;264;186;1046;1078164;874896;220224;2173284;2347146,72;0;0;05/09/2024
31/08/2024;KCNYM-001;YM-VNC;2310396107;YM 472E28.6;44160;7830;5520;57510;73703040;24218190;5983680;103904910;112217302,8;0;0;05/09/2024
31/08/2024;KCNYM-002;YM-Thịnh Vượng;2310396110;YM 472E28.6;15934;5891;3442;25267;28824606;19522774;4075328;52422708;56616524,64;0;0;05/09/2024
31/08/2024;KCNYM-002;YM-Thịnh Vượng;2310396111;YM 472E28.6;1190;514;504;2208;2152710;1703396;596736;4452842;4809069,36;0;0;15/09/2024
31/08/2024;KCNYM-003;YM-Jili;2310396105;YM 472E28.6;46891;17958;11050;75899;84825819;59512812;13083200;157421831;170015577,5;0;0;15/09/2024
31/08/2024;KCNYM-004;YM-MQ-IDS;2310396106;YM 472E28.6;40352;17680;10900;68932;72996768;58591520;12905600;144493888;156053399;0;0;15/09/2024
31/08/2024;KCNTH-003;TH-Hợp Lực;2310396109;TH476 E11.9;3180;1422;1349;5951;5752620;4712508;1597216;12062344;13027331,52;0;0;05/09/2024
10/09/2024;EVN-TH;EVN-TH;2046008580;TH486 E11.9;-40564;-13382;-12545;-66491;-67701316;-41390526;-13598780;-122690622;-132505871,8;0;0;15/09/2024
10/09/2024;EVN-TH;EVN-TH;2046008583;TH484 E11.9;0;0;0;0;0;0;0;0;0;0;0;15/09/2024
10/09/2024;EVN-TH;EVN-TH;2110155910;TH476 E11.9;-2596;-1012;-1012;-4620;-4332724;-3130116;-1097008;-8559848;-9244635,84;0;0;15/09/2024
10/09/2024;EVN-YM;EVN-YM;3001347;YM 472E28.6;-25500;-5340;-7110;-37950;-41769000;-16201560;-7565040;-65535600;-70778448;0;0;20/09/2024
10/09/2024;EVN-YM;EVN-YM;2346021347;YM 472E28.6;-37524;-15348;-8106;-60978;-62627556;-47471364;-8786904;-118885824;-128396689,9;0;0;20/09/2024
10/09/2024;KCNTH-002;TH-Asahi;2210575757;TH486 E11.9;29052;9900;9312;48264;52555068;32808600;11025408;96389076;96389076;0;0;20/09/2024
15/09/2024;KCNTH-008;TH-Hum&C;2410320616;TH486 E11.9;0;0;0;0;0;0;0;0;0;0;0;20/09/2024
15/09/2024;KCNYM-001;YM-VNC;2310396107;YM 472E28.6;48900;8040;13800;70740;81614100;24867720;14959200;121441020;131156301,6;0;0;22/09/2024
15/09/2024;KCNYM-003;YM-Jili;2310396105;YM 472E28.6;30493;13387;5595;49475;55161837;44364518;6624480;106150835;114642901,8;0;0;25/09/2024
15/09/2024;KCNYM-004;YM-MQ-IDS;2310396106;YM 472E28.6;23132;10516;1232;34880;41845788;34850024;1458688;78154500;84406860;0;0;25/09/2024
17/09/2024;KCNTH-010A;TH-SauSum;2410320615;TH486 E11.9;0;0;0;0;0;0;0;0;0;0;0;25/09/2024
20/09/2024;EVN-TH;EVN-TH;2046008580;TH486 E11.9;-56036;-20491;-15891;-92418;-93524084;-63378663;-17225844;-174128591;-188058878,3;0;0;25/09/2024
20/09/2024;EVN-TH;EVN-TH;2046008583;TH484 E11.9;0;0;0;0;0;0;0;0;0;0;0;25/09/2024
20/09/2024;EVN-TH;EVN-TH;2110155910;TH476 E11.9;-2992;-1408;-880;-5280;-4993648;-4354944;-953920;-10302512;-11126712,96;0;0;25/09/2024
20/09/2024;EVN-YM;EVN-YM;2346021347;YM 472E28.6;-60642;-25688;-12024;-98354;-101211498;-79452984;-13034016;-193698498;-209194377,8;0;0;05/10/2024
20/09/2024;EVN-YM;EVN-YM;3001347;YM 472E28.6;-41550;-6840;-9960;-58350;-68058900;-20752560;-10597440;-99408900;-107361612;0;0;05/10/2024
20/09/2024;KCNTH-002;TH-Asahi;2210575757;TH486 E11.9;42738;15546;13128;71412;77313042;51519444;15543552;144376038;144376038;0;0;05/10/2024
30/09/2024;EVN-PĐ;EVN-PĐ;21041898;PĐ472;-24800;-7960;-2160;-34920;-40622400;-24150640;-2298240;-67071280;-72436982,4;0;0;05/10/2024
30/09/2024;EVN-TH;EVN-TH;2046008580;TH486 E11.9;-58127;-18818;-16727;-93672;-97013963;-58204074;-18132068;-173350105;-187218113,4;0;0;05/10/2024
30/09/2024;EVN-TH;EVN-TH;2046008583;TH484 E11.9;0;0;0;0;0;0;0;0;0;0;0;05/10/2024
30/09/2024;EVN-TH;EVN-TH;2110155910;TH476 E11.9;-3828;-1452;-748;-6028;-6388932;-4491036;-810832;-11690800;-12626064;0;0;05/10/2024
30/09/2024;EVN-YM;EVN-YM;3001347;YM 472E28.6;-37860;-3750;-9510;-51120;-62014680;-11377500;-10118640;-83510820;-90191685,6;0;0;05/10/2024
30/09/2024;EVN-YM;EVN-YM;2346021347;YM 472E28.6;-58188;-21978;-12570;-92736;-97115772;-67977954;-13625880;-178719606;-193017174,5;0;0;05/10/2024
30/09/2024;KCNPĐ-001;PĐ-BQL;2310231609;PĐ472;890;372;525;1787;1610010;1232808;621600;3464418;3741571,44;0;0;05/10/2024
30/09/2024;KCNPĐ-001;PĐ-BQL;2310231610;PĐ472;0;0;0;0;0;0;0;0;0;0;0;05/10/2024
30/09/2024;KCNPĐ-002;PĐ-AMP;2310231611;PĐ472;23698;7615;1579;32892;42869682;25236110;1869536;69975328;75573354,24;0;0;05/10/2024
30/09/2024;KCNTH-001;TH-BQL;2210575660;TH486 E11.9;5248;2194;1711;9153;9493632;7270916;2025824;18790372;20293601,76;0;0;05/10/2024
30/09/2024;KCNTH-001;TH-BQL;2310396104;TH476 E11.9;23;5;0;28;41607;16570;0;58177;62831,16;0;0;05/10/2024
30/09/2024;KCNTH-001;TH-BQL;2310396108;TH486 E11.9;669;384;527;1580;1210221;1272576;623968;3106765;3355306,2;0;0;05/10/2024
30/09/2024;KCNTH-002;TH-Asahi;2210575757;TH486 E11.9;42936;14106;12756;69798;77671224;46747284;15103104;139521612;139521612;0;0;05/10/2024
30/09/2024;KCNTH-004;TH-HANA;2410131385;TH486 E11.9;2445;907;544;3896;4423005;3005798;644096;8072899;8718730,92;0;0;05/10/2024
30/09/2024;KCNTH-005;TH-FTA;2410131539;TH486 E11.9;6168;1925;1747;9840;11157912;6379450;2068448;19605810;21174274,8;0;0;05/10/2024
30/09/2024;KCNTH-006;TH-Giza;2410131376;TH486 E11.9;4601;1519;1114;7234;8323209;5033966;1318976;14676151;15850243,08;0;0;05/10/2024
30/09/2024;KCNTH-007;TH-Sinher;2410131383;TH486 E11.9;13592;4020;2032;19644;24587928;13322280;2405888;40316096;40316096;0;0;05/10/2024
30/09/2024;KCNTH-008;TH-Hum&C;2410320616;TH486 E11.9;216;74;0;290;390744;245236;0;635980;686858,4;0;0;05/10/2024
30/09/2024;KCNTH-009A;TH-Hợp Nhất;2410131547;TH486 E11.9;903;315;171;1389;1633527;1043910;202464;2879901;3110293,08;0;0;05/10/2024
30/09/2024;KCNTH-010A;TH-SauSum;2410320615;TH486 E11.9;2478;927;709;4114;4482702;3072078;839456;8394236;9065774,88;0;0;05/10/2024
30/09/2024;KCNYM-001;YM-VNC;2310396107;YM 472E28.6;56010;7890;12780;76680;93480690;24403770;13853520;131737980;142277018,4;0;0;05/10/2024
30/09/2024;KCNYM-002;YM-Thịnh Vượng;2310396110;YM 472E28.6;25022;8805;3752;37579;45264798;29179770;4442368;78886936;78886936;0;0;05/10/2024
30/09/2024;KCNYM-002;YM-Thịnh Vượng;2310396111;YM 472E28.6;8125;3030;1442;12597;14698125;10041420;1707328;26446873;26446873;0;0;14/10/2024
30/09/2024;KCNYM-003;YM-Jili;2310396105;YM 472E28.6;32112;13323;5928;51363;58090608;44152422;7018752;109261782;118002724,6;0;0;15/10/2024
30/09/2024;KCNYM-004;YM-MQ-IDS;2310396106;YM 472E28.6;35332;12960;10016;58308;63915588;42949440;11858944;118723972;128221889,8;0;0;15/10/2024
30/09/2024;KCNTH-003;TH-Hợp Lực;2310396109;TH476 E11.9;9413;3892;2632;15937;17028117;12898088;3116288;33042493;35685892,44;0;0;05/10/2024
09/10/2024;KCNYM-005;YM-TITAN;2410121454;YM 472E28.6;0;0;0;0;0;0;0;0;0;0;0;15/10/2024
10/10/2024;EVN-TH;EVN-TH;2046008580;TH486 E11.9;-58545;-20909;-15891;-95345;-97711605;-64671537;-17225844;-179608986;-193977704,9;0;0;15/10/2024
10/10/2024;EVN-TH;EVN-TH;2046008583;TH484 E11.9;0;0;0;0;0;0;0;0;0;0;0;15/10/2024
10/10/2024;EVN-TH;EVN-TH;2110155910;TH476 E11.9;-3740;-1760;-660;-6160;-6242060;-5443680;-715440;-12401180;-13393274,4;0;0;15/10/2024
10/10/2024;EVN-YM;EVN-YM;2346021347;YM 472E28.6;-59980;-25118;-16698;-101796;-100106620;-77689974;-18100632;-195897226;-211569004,1;0;0;16/10/2024
10/10/2024;EVN-YM;EVN-YM;3001347;YM 472E28.6;-42900;-9090;-8070;-60060;-70270200;-27579060;-8586480;-106435740;-114950599,2;0;0;16/10/2024
10/10/2024;KCNTH-002;TH-Asahi;2210575757;TH486 E11.9;43458;15372;12192;71022;78615522;50942808;14435328;143993658;143993658;0;0;16/10/2024
11/10/2024;EVN-PĐ;EVN-PĐ;21041898;PĐ472;-10960;-3600;-880;-15440;-17952480;-10922400;-936320;-29811200;-32196096;0;0;16/10/2024
11/10/2024;EVN-TH;EVN-TH;2046008580;TH486 E11.9;-6273;-2509;-1673;-10455;-10469637;-7760337;-1813532;-20043506;-21646986,48;0;0;16/10/2024
11/10/2024;EVN-TH;EVN-TH;2046008583;TH484 E11.9;0;0;0;0;0;0;0;0;0;0;0;16/10/2024
11/10/2024;EVN-TH;EVN-TH;2110155910;TH476 E11.9;-484;-264;-88;-836;-807796;-816552;-95392;-1719740;-1857319,2;0;0;16/10/2024
11/10/2024;EVN-YM;EVN-YM;2346021347;YM 472E28.6;-6180;-2948;-954;-10082;-10314420;-9118164;-1034136;-20466720;-22104057,6;0;0;16/10/2024
11/10/2024;EVN-YM;EVN-YM;3001347;YM 472E28.6;-2940;-540;-150;-3630;-4815720;-1638360;-159600;-6613680;-7142774,4;0;0;16/10/2024
11/10/2024;KCNPĐ-001;PĐ-BQL;2310231609;PĐ472;352;184;195;731;636768;609776;230880;1477424;1595617,92;0;0;16/10/2024
11/10/2024;KCNPĐ-001;PĐ-BQL;2310231610;PĐ472;0;0;0;0;0;0;0;0;0;0;0;16/10/2024
11/10/2024;KCNPĐ-002;PĐ-AMP;2310231611;PĐ472;10438;3434;672;14544;18882342;11380276;795648;31058266;33542927,28;0;0;16/10/2024
11/10/2024;KCNTH-001;TH-BQL;2210575660;TH486 E11.9;1810;932;631;3373;3274290;3088648;747104;7110042;7678845,36;0;0;16/10/2024
11/10/2024;KCNTH-001;TH-BQL;2310396104;TH476 E11.9;0;0;0;0;0;0;0;0;0;0;0;16/10/2024
11/10/2024;KCNTH-001;TH-BQL;2310396108;TH486 E11.9;405;222;238;865;732645;735708;281792;1750145;1890156,6;0;0;16/10/2024
11/10/2024;KCNTH-004;TH-HANA;2410131385;TH486 E11.9;859;351;168;1378;1553931;1163214;198912;2916057;3149341,56;0;0;16/10/2024
11/10/2024;KCNTH-005;TH-FTA;2410131539;TH486 E11.9;1893;662;498;3053;3424437;2193868;589632;6207937;6704571,96;0;0;16/10/2024
11/10/2024;KCNTH-006;TH-Giza;2410131376;TH486 E11.9;2038;714;412;3164;3686742;2366196;487808;6540746;7064005,68;0;0;16/10/2024
11/10/2024;KCNTH-007;TH-Sinher;2410131383;TH486 E11.9;4136;1268;672;6076;7482024;4202152;795648;12479824;12479824;0;0;16/10/2024
11/10/2024;KCNTH-008;TH-Hum&C;2410320616;TH486 E11.9;973;480;157;1610;1760157;1590720;185888;3536765;3819706,2;0;0;16/10/2024
11/10/2024;KCNTH-009A;TH-Hợp Nhất;2410131547;TH486 E11.9;171;53;50;274;309339;175642;59200;544181;587715,48;0;0;16/10/2024
11/10/2024;KCNTH-010A;TH-SauSum;2410320615;TH486 E11.9;2632;991;718;4341;4761288;3284174;850112;8895574;9607219,92;0;0;16/10/2024
11/10/2024;KCNYM-001;YM-VNC;2310396107;YM 472E28.6;45840;9630;8220;63690;76506960;29785590;8910480;115203030;124419272,4;0;0;16/10/2024
11/10/2024;KCNYM-002A;YM-LiHua;2310396110;YM 472E28.6;10192;3941;1542;15675;18437328;13060474;1825728;33323530;33323530;0;0;16/10/2024
11/10/2024;KCNYM-002A;YM-LiHua;2310396111;YM 472E28.6;2733;1194;507;4434;4943997;3956916;600288;9501201;9501201;0;0;16/10/2024
11/10/2024;KCNYM-003;YM-Jili;2310396105;YM 472E28.6;26904;11467;6466;44837;48669336;38001638;7655744;94326718;101872855,4;0;0;20/10/2024
11/10/2024;KCNYM-004;YM-MQ-IDS;2310396106;YM 472E28.6;25660;11108;8988;45756;46418940;36811912;10641792;93872644;101382455,5;0;0;20/10/2024
11/10/2024;KCNYM-005;YM-TITAN;2410121454;YM 472E28.6;52;21;8;81;149240;103677;13968;266885;288235,8;0;0;20/10/2024
11/10/2024;KCNTH-003;TH-Hợp Lực;2310396109;TH476 E11.9;4253;2026;738;7017;7693677;6714164;873792;15281633;16504163,64;0;0;16/10/2024
15/10/2024;KCNYM-001;YM-VNC;2310396107;YM 472E28.6;11100;1260;4950;17310;19413900;4084920;5623200;29122020;31451781,6;0;0;24/10/2024
15/10/2024;KCNYM-003;YM-Jili;2310396105;YM 472E28.6;13059;3878;2008;18945;24759864;13472172;2491928;40723964;43981881,12;0;0;25/10/2024
15/10/2024;KCNYM-004;YM-MQ-IDS;2310396106;YM 472E28.6;9844;3296;2516;15656;18664224;11450304;3122356;33236884;35895834,72;0;0;25/10/2024
19/10/2024;KCN03-002A;03-COFICO;2410883989;AT481 E28.24;0;0;0;0;0;0;0;0;0;0;0;25/10/2024
20/10/2024;EVN-TH;EVN-TH;2046008580;TH486 E11.9;-52691;-19236;-14636;-86563;-92156559;-62363112;-16626496;-171146167;-184837860,4;0;0;25/10/2024
20/10/2024;EVN-TH;EVN-TH;2046008583;TH484 E11.9;0;0;0;0;0;0;0;0;0;0;0;25/10/2024
20/10/2024;EVN-TH;EVN-TH;2110155910;TH476 E11.9;-3300;-1496;-748;-5544;-5771700;-4850032;-849728;-11471460;-12389176,8;0;0;25/10/2024
20/10/2024;EVN-YM;EVN-YM;3001347;YM 472E28.6;-30330;-4080;-14820;-49230;-52076610;-12978480;-16524300;-81579390;-88105741,2;0;0;30/10/2024
20/10/2024;EVN-YM;EVN-YM;2346021347;YM 472E28.6;-60406;-24192;-12860;-97458;-105650094;-78430464;-14608960;-198689518;-214584679,4;0;0;05/11/2024
20/10/2024;KCNTH-002;TH-Asahi;2210575757;TH486 E11.9;42714;15264;12414;70392;80985744;53027136;15405774;149418654;149418654;0;0;05/11/2024
25/10/2024;KCN03-001;03-EcoLand;2410883991;AT479 E28.24;0;0;0;0;0;0;0;0;0;0;0;05/11/2024
31/10/2024;EVN-03;EVN-03;2246014403;AT479 E28.24;-418;-418;0;-836;-717706;-1329658;0;-2047364;-2211153,12;0;0;05/11/2024
31/10/2024;EVN-03;EVN-03;2246014464;AT481 E28.24;-2091;-836;-836;-3763;-3590247;-2659316;-932140;-7181703;-7756239,24;0;0;05/11/2024
31/10/2024;EVN-PĐ;EVN-PĐ;21041898;PĐ472;-21960;-6480;-1520;-29960;-37705320;-20612880;-1694800;-60013000;-64814040;0;0;05/11/2024
31/10/2024;EVN-TH;EVN-TH;2046008580;TH486 E11.9;-57709;-19236;-17145;-94090;-100933041;-62363112;-19476720;-182772873;-197394702,8;0;0;05/11/2024
31/10/2024;EVN-TH;EVN-TH;2046008583;TH484 E11.9;0;0;0;0;0;0;0;0;0;0;0;05/11/2024
31/10/2024;EVN-TH;EVN-TH;2110155910;TH476 E11.9;-3696;-1672;-704;-6072;-6464304;-5420624;-799744;-12684672;-13699445,76;0;0;05/11/2024
31/10/2024;EVN-YM;EVN-YM;3001347;YM 472E28.6;-31890;-4350;-7890;-44130;-54755130;-13837350;-8797350;-77389830;-83581016,4;0;0;05/11/2024
31/10/2024;EVN-YM;EVN-YM;2346021347;YM 472E28.6;-72974;-27746;-15214;-115934;-127631526;-89952532;-17283104;-234867162;-253656535;0;0;05/11/2024
31/10/2024;KCN03-001;03-EcoLand;2410883991;AT479 E28.24;0;0;0;0;0;0;0;0;0;0;0;05/11/2024
31/10/2024;KCN03-002A;03-COFICO;2410883989;AT481 E28.24;1866;762;773;3401;3537936;2647188;959293;7144417;7715970,36;0;0;05/11/2024
31/10/2024;KCNPĐ-001;PĐ-BQL;2310231609;PĐ472;614;256;334;1204;1164144;889344;414494;2467982;2665420,56;0;0;05/11/2024
31/10/2024;KCNPĐ-001;PĐ-BQL;2310231610;PĐ472;0;0;0;0;0;0;0;0;0;0;0;05/11/2024
31/10/2024;KCNPĐ-002;PĐ-AMP;2310231611;PĐ472;19951;5904;1070;26925;37827096;20510496;1327870;59665462;64438698,96;0;0;05/11/2024
31/10/2024;KCNTH-001;TH-BQL;2210575660;TH486 E11.9;2827;1446;1114;5387;5359992;5023404;1382474;11765870;12707139,6;0;0;05/11/2024
31/10/2024;KCNTH-001;TH-BQL;2310396104;TH476 E11.9;0;0;0;0;0;0;0;0;0;0;0;05/11/2024
31/10/2024;KCNTH-001;TH-BQL;2310396108;TH486 E11.9;938;479;467;1884;1778448;1664046;579547;4022041;4343804,28;0;0;05/11/2024
31/10/2024;KCNTH-002;TH-Asahi;2210575757;TH486 E11.9;41208;13470;12906;67584;78130368;46794780;16016346;140941494;140941494;0;0;05/11/2024
31/10/2024;KCNTH-004;TH-HANA;2410131385;TH486 E11.9;685;268;110;1063;1298760;931032;136510;2366302;2555606,16;0;0;05/11/2024
31/10/2024;KCNTH-005;TH-FTA;2410131539;TH486 E11.9;3594;1171;768;5533;6814224;4068054;953088;11835366;12782195,28;0;0;05/11/2024
31/10/2024;KCNTH-006;TH-Giza;2410131376;TH486 E11.9;3630;1182;858;5670;6882480;4106268;1064778;12053526;13017808,08;0;0;05/11/2024
31/10/2024;KCNTH-007;TH-Sinher;2410131383;TH486 E11.9;6468;2136;1280;9884;12263328;7420464;1588480;21272272;21272272;0;0;05/11/2024
31/10/2024;KCNTH-008;TH-Hum&C;2410320616;TH486 E11.9;4581;1829;869;7279;8685576;6353946;1078429;16117951;17407387,08;0;0;05/11/2024
31/10/2024;KCNTH-009A;TH-Hợp Nhất;2410131547;TH486 E11.9;514;166;143;823;974544;576684;177463;1728691;1866986,28;0;0;05/11/2024
31/10/2024;KCNTH-010A;TH-SauSum;2410320615;TH486 E11.9;5317;2052;1245;8614;10081032;7128648;1545045;18754725;20255103;0;0;05/11/2024
31/10/2024;KCNYM-001;YM-VNC;2310396107;YM 472E28.6;51120;7170;17760;76050;89408880;23245140;20175360;132829380;143455730,4;0;0;05/11/2024
31/10/2024;KCNYM-002A;YM-LiHua;2310396110;YM 472E28.6;20427;8013;3061;31501;38729592;27837162;3798701;70365455;70365455;0;0;05/11/2024
31/10/2024;KCNYM-002A;YM-LiHua;2310396111;YM 472E28.6;7050;3370;742;11162;13366800;11707380;920822;25995002;25995002;0;0;05/11/2024
31/10/2024;KCNYM-003;YM-Jili;2310396105;YM 472E28.6;45026;17248;9128;71402;85369296;59919552;11327848;156616696;169146031,7;0;0;15/11/2024
31/10/2024;KCNYM-004;YM-MQ-IDS;2310396106;YM 472E28.6;35164;15172;9040;59376;66670944;52707528;11218640;130597112;141044881;0;0;15/11/2024
31/10/2024;KCNYM-005;YM-TITAN;2410121454;YM 472E28.6;543;217;85;845;1632801;1122758;155550;2911109;3143997,72;0;0;15/11/2024
31/10/2024;KCNTH-003;TH-Hợp Lực;2310396109;TH476 E11.9;7051;3166;1439;11656;13368696;10998684;1785799;26153179;28245433,32;0;0;05/11/2024
10/11/2024;EVN-03;EVN-03;2246014403;AT479 E28.24;-1756;-544;-753;-3053;-3015052;-1730464;-839595;-5585111;-6031919,88;0;0;15/11/2024
10/11/2024;EVN-03;EVN-03;2246014464;AT481 E28.24;-2049;-836;-878;-3763;-3518133;-2659316;-978970;-7156419;-7728932,52;0;0;15/11/2024
10/11/2024;EVN-TH;EVN-TH;2046008580;TH486 E11.9;-52691;-18818;-16727;-88236;-92156559;-61007956;-19001872;-172166387;-185939698;0;0;15/11/2024
10/11/2024;EVN-TH;EVN-TH;2046008583;TH484 E11.9;0;0;0;0;0;0;0;0;0;0;0;15/11/2024
10/11/2024;EVN-TH;EVN-TH;2110155910;TH476 E11.9;-3212;-1672;-528;-5412;-5617788;-5420624;-599808;-11638220;-12569277,6;0;0;15/11/2024
10/11/2024;EVN-YM;EVN-YM;3001347;YM 472E28.6;-32340;-5430;-2250;-40020;-55527780;-17272830;-2508750;-75309360;-81334108,8;0;0;15/11/2024
10/11/2024;EVN-YM;EVN-YM;2346021347;YM 472E28.6;-64556;-26826;-15606;-106988;-112908444;-86969892;-17728416;-217606752;-235015292,2;0;0;20/11/2024
10/11/2024;KCNTH-002;TH-Asahi;2210575757;TH486 E11.9;39288;13830;13146;66264;74490048;48045420;16314186;138849654;138849654;0;0;20/11/2024
10/11/2024;KCNYM-001;YM-VNC;2310396107;YM 472E28.6;32340;5430;2250;40020;56562660;17604060;2556000;76722720;82860537,6;0;0;25/11/2024
15/11/2024;KCNYM-003;YM-Jili;2310396105;YM 472E28.6;39845;15768;8782;64395;75546120;54778032;10898462;141222614;152520423,1;0;0;25/11/2024
15/11/2024;KCNYM-004;YM-MQ-IDS;2310396106;YM 472E28.6;35652;14412;10656;60720;67596192;50067288;13224096;130887576;141358582,1;0;0;25/11/2024
20/11/2024;EVN-03;EVN-03;2246014403;AT479 E28.24;-2133;-627;-585;-3345;-3662361;-1994487;-652275;-6309123;-6813852,84;0;0;25/11/2024
20/11/2024;EVN-03;EVN-03;2246014464;AT481 E28.24;-2133;-753;-836;-3722;-3662361;-2395293;-932140;-6989794;-7548977,52;0;0;25/11/2024
20/11/2024;EVN-TH;EVN-TH;2046008580;TH486 E11.9;-61055;-20491;-16727;-98273;-106785195;-66431822;-19001872;-192218889;-207596400,1;0;0;25/11/2024
20/11/2024;EVN-TH;EVN-TH;2046008583;TH484 E11.9;0;0;0;0;0;0;0;0;0;0;0;25/11/2024
20/11/2024;EVN-TH;EVN-TH;2110155910;TH476 E11.9;-4048;-1892;-616;-6556;-7079952;-6133864;-699776;-13913592;-15026679,36;0;0;25/11/2024
20/11/2024;EVN-YM;EVN-YM;3001347;YM 472E28.6;-25020;-3780;-7320;-36120;-42959340;-12024180;-8161800;-63145320;-68196945,6;0;0;25/11/2024
20/11/2024;EVN-YM;EVN-YM;2346021347;YM 472E28.6;-68132;-25900;-17464;-111496;-119162868;-83967800;-19839104;-222969772;-240807353,8;0;0;05/12/2024
20/11/2024;KCNTH-002;TH-Asahi;2210575757;TH486 E11.9;42684;13932;12606;69222;80928864;48399768;15644046;144972678;144972678;0;0;05/12/2024
20/11/2024;KCNYM-001;YM-VNC;2310396107;YM 472E28.6;25020;3780;7320;36120;43759980;12254760;8315520;64330260;69476680,8;0;0;05/12/2024
30/11/2024;EVN-03;EVN-03;2246014403;AT479 E28.24;-2384;-836;-836;-4056;-4093328;-2659316;-932140;-7684784;-8299566,72;0;0;05/12/2024
30/11/2024;EVN-03;EVN-03;2246014464;AT481 E28.24;-1380;-544;-711;-2635;-2369460;-1730464;-792765;-4892689;-5284104,12;0;0;05/12/2024
30/11/2024;EVN-PĐ;EVN-PĐ;21041898;PĐ472;-25000;-8000;-2720;-35720;-42925000;-25448000;-3032800;-71405800;-77118264;0;0;05/12/2024
30/11/2024;EVN-TH;EVN-TH;2046008580;TH486 E11.9;-58127;-23000;-14636;-95763;-101664123;-74566000;-16626496;-192856619;-208285148,5;0;0;05/12/2024
30/11/2024;EVN-TH;EVN-TH;2046008583;TH484 E11.9;0;0;0;0;0;0;0;0;0;0;0;05/12/2024
30/11/2024;EVN-TH;EVN-TH;2110155910;TH476 E11.9;-3608;-1892;-484;-5984;-6310392;-6133864;-549824;-12994080;-14033606,4;0;0;05/12/2024
30/11/2024;EVN-YM;EVN-YM;3001347;YM 472E28.6;-12240;-2490;-2040;-16770;-21016080;-7920690;-2274600;-31211370;-33708279,6;0;0;05/12/2024
30/11/2024;EVN-YM;EVN-YM;2346021347;YM 472E28.6;-54832;-20886;-14872;-90590;-95901168;-67712412;-16894592;-180508172;-194948825,8;0;0;05/12/2024
30/11/2024;KCN03-001;03-EcoLand;2410883991;AT479 E28.24;6495;2335;1971;10801;12314520;8111790;2446011;22872321;24702106,68;0;0;05/12/2024
30/11/2024;KCN03-002A;03-COFICO;2410883989;AT481 E28.24;5323;2150;2302;9775;10092408;7469100;2856782;20418290;22051753,2;0;0;05/12/2024
30/11/2024;KCNPĐ-001;PĐ-BQL;2310231609;PĐ472;1092;482;839;2413;2070432;1674468;1041199;4786099;5168986,92;0;0;05/12/2024
30/11/2024;KCNPĐ-001;PĐ-BQL;2310231610;PĐ472;0;0;0;0;0;0;0;0;0;0;0;05/12/2024
30/11/2024;KCNPĐ-002;PĐ-AMP;2310231611;PĐ472;24202;7613;1723;33538;45886992;26447562;2138243;74472797;80430620,76;0;0;05/12/2024
30/11/2024;KCNTH-001;TH-BQL;2210575660;TH486 E11.9;3585;1947;1573;7105;6797160;6763878;1952093;15513131;16754181,48;0;0;05/12/2024
30/11/2024;KCNTH-001;TH-BQL;2310396104;TH476 E11.9;0;0;0;0;0;0;0;0;0;0;0;05/12/2024
30/11/2024;KCNTH-001;TH-BQL;2310396108;TH486 E11.9;1387;791;632;2810;2629752;2747934;784312;6161998;6654957,84;0;0;05/12/2024
30/11/2024;KCNTH-002;TH-Asahi;2210575757;TH486 E11.9;36006;13368;11388;60762;68267376;46440432;14132508;128840316;128840316;0;0;05/12/2024
30/11/2024;KCNTH-005;TH-FTA;2410131539;TH486 E11.9;4396;1318;739;6453;8334816;4578732;917099;13830647;14937098,76;0;0;05/12/2024
30/11/2024;KCNTH-006;TH-Giza;2410131376;TH486 E11.9;6459;2310;1371;10140;12246264;8024940;1701411;21972615;23730424,2;0;0;05/12/2024
30/11/2024;KCNTH-007;TH-Sinher;2410131383;TH486 E11.9;6544;2188;1704;10436;12407424;7601112;2114664;22123200;22123200;0;0;05/12/2024
30/11/2024;KCNTH-008;TH-Hum&C;2410320616;TH486 E11.9;18250;7925;1443;27618;34602000;27531450;1790763;63924213;69038150,04;0;0;05/12/2024
30/11/2024;KCNTH-009A;TH-Hợp Nhất;2410131547;TH486 E11.9;1038;258;175;1471;1968048;896292;217175;3081515;3328036,2;0;0;05/12/2024
30/11/2024;KCNTH-010A;TH-SauSum;2410320615;TH486 E11.9;8006;3192;1870;13068;15179376;11089008;2320670;28589054;30876178,32;0;0;05/12/2024
30/11/2024;KCNYM-001;YM-VNC;2310396107;YM 472E28.6;12240;2490;2040;16770;21407760;8072580;2317440;31797780;34341602,4;0;0;05/12/2024
30/11/2024;KCNYM-002A;YM-LiHua;2310396110;YM 472E28.6;27422;11474;6288;45184;51992112;39860676;7803408;99656196;99656196;0;0;05/12/2024
30/11/2024;KCNYM-002A;YM-LiHua;2310396111;YM 472E28.6;10118;4483;2701;17302;19183728;15573942;3351941;38109611;38109611;0;0;05/12/2024
30/11/2024;KCNYM-003;YM-Jili;2310396105;YM 472E28.6;44054;15526;10896;70476;83526384;53937324;13521936;150985644;163064495,5;0;0;06/12/2024
30/11/2024;KCNYM-004;YM-MQ-IDS;2310396106;YM 472E28.6;30064;11768;9428;51260;57001344;40882032;11700148;109583524;118350205,9;0;0;13/12/2024
30/11/2024;KCNYM-005;YM-TITAN;2410121454;YM 472E28.6;3189;1142;813;5144;9589323;5908708;1487790;16985821;18344686,68;0;0;15/12/2024
30/11/2024;KCNTH-003;TH-Hợp Lực;2310396109;TH476 E11.9;10836;5443;1610;17889;20545056;18908982;1998010;41452048;44768211,84;0;0;05/12/2024
01/12/2024;KCNYM-006;YM-Pacific;2410932742;YM 472E28.6;0;0;0;0;0;0;0;0;0;0;0;15/12/2024
08/12/2024;EVN-YM;EVN-YM;2346021369;YM 474E28.6;0;0;0;0;0;0;0;0;0;0;0;15/12/2024
10/12/2024;EVN-03;EVN-03;2246014464;AT481 E28.24;-2216;-878;-962;-4056;-3804872;-2792918;-1072630;-7670420;-8284053,6;0;0;15/12/2024
10/12/2024;EVN-03;EVN-03;2246014403;AT479 E28.24;-4725;-1589;-1422;-7736;-8112825;-5054609;-1585530;-14752964;-15933201,12;0;0;15/12/2024
10/12/2024;EVN-TH;EVN-TH;2046008580;TH486 E11.9;-54364;-19236;-15473;-89073;-95082636;-62363112;-17577328;-175023076;-189024922,1;0;0;15/12/2024
10/12/2024;EVN-TH;EVN-TH;2046008583;TH484 E11.9;0;0;0;0;0;0;0;0;0;0;0;15/12/2024
10/12/2024;EVN-TH;EVN-TH;2110155910;TH476 E11.9;-4224;-1848;-924;-6996;-7387776;-5991216;-1049664;-14428656;-15582948,48;0;0;15/12/2024
10/12/2024;EVN-YM;EVN-YM;3001347;YM 472E28.6;-17220;-3540;-2880;-23640;-29566740;-11260740;-3211200;-44038680;-47561774,4;0;0;15/12/2024
10/12/2024;EVN-YM;EVN-YM;2346021347;YM 472E28.6;-68972;-28220;-19664;-116856;-120632028;-91489240;-22338304;-234459572;-253216337,8;0;0;15/12/2024
10/12/2024;EVN-YM;EVN-YM;2346021369;YM 474E28.6;-23760;-8160;-5680;-37600;-40795920;-25956960;-6333200;-73086080;-78932966,4;0;0;15/12/2024
10/12/2024;KCNTH-002;TH-Asahi;2210575757;TH486 E11.9;36366;11772;12012;60150;68949936;40895928;14906892;124752756;124752756;0;0;15/12/2024
10/12/2024;KCNYM-001;YM-VNC;2310396107;YM 472E28.6;17220;3540;2880;23640;30117780;11476680;3271680;44866140;48455431,2;0;0;24/12/2024
10/12/2024;KCNYM-003;YM-Jili;2310396105;YM 474E28.6;23293;8736;5917;37946;44163528;30348864;7342997;81855389;88403820,12;0;0;25/12/2024
10/12/2024;KCNYM-004;YM-MQ-IDS;2310396106;YM 474E28.6;25768;10556;6752;43076;48856128;36671544;8379232;93906904;101419456,3;0;0;25/12/2024
19/12/2024;KCN03-003A;03-ANTACO;2410992743;AT479 E28.24;0;0;0;0;0;0;0;0;0;0;0;25/12/2024
20/12/2024;EVN-03;EVN-03;2246014464;AT481 E28.24;-1631;-711;-669;-3011;-2800427;-2261691;-745935;-5808053;-6272697,24;0;0;25/12/2024
20/12/2024;EVN-03;EVN-03;2246014403;AT479 E28.24;-4767;-1840;-1756;-8363;-8184939;-5853040;-1957940;-15995919;-17275592,52;0;0;25/12/2024
20/12/2024;EVN-TH;EVN-TH;2046008580;TH486 E11.9;-55200;-22582;-14636;-92418;-96544800;-73210844;-16626496;-186382140;-201292711,2;0;0;25/12/2024
20/12/2024;EVN-TH;EVN-TH;2046008583;TH484 E11.9;0;0;0;0;0;0;0;0;0;0;0;25/12/2024
20/12/2024;EVN-TH;EVN-TH;2110155910;TH476 E11.9;-4488;-2200;-836;-7524;-7849512;-7132400;-949696;-15931608;-17206136,64;0;0;25/12/2024
20/12/2024;EVN-YM;EVN-YM;2346021347;YM 472E28.6;-14330;-5538;-3490;-23358;-25063170;-17954196;-3964640;-46982006;-50740566,48;0;0;25/12/2024
20/12/2024;EVN-YM;EVN-YM;3001347;YM 472E28.6;-21030;-4110;-3150;-28290;-36108510;-13073910;-3512250;-52694670;-56910243,6;0;0;25/12/2024
20/12/2024;EVN-YM;EVN-YM;2346021369;YM 474E28.6;-59280;-21360;-17520;-98160;-101783760;-67946160;-19534800;-189264720;-204405897,6;0;0;25/12/2024
20/12/2024;KCNTH-002;TH-Asahi;2210575757;TH486 E11.9;35172;13110;11592;59874;66686112;45544140;14385672;126615924;126615924;0;0;25/12/2024
20/12/2024;KCNYM-001;YM-VNC;2310396107;YM 474E28.6;21030;4110;3150;28290;36781470;13324620;3578400;53684490;57979249,2;0;0;03/01/2025
20/12/2024;KCNYM-003;YM-Jili;2310396105;YM 474E28.6;27606;10283;7754;45643;52340976;35723142;9622714;97686832;105501778,6;0;0;03/01/2025
20/12/2024;KCNYM-004;YM-MQ-IDS;2310396106;YM 474E28.6;23948;9860;6576;40384;45405408;34253640;8160816;87819864;94845453,12;0;0;05/01/2025
29/12/2024;KCNTH-003A;TH-Be Bright;2410131387;TH476 E11.9;0;0;0;0;0;0;0;0;0;0;0;05/01/2025
29/12/2024;KCNTH-003A;TH-Be Bright;2410131380;TH476 E11.9;0;0;0;0;0;0;0;0;0;0;0;05/01/2025
31/12/2024;EVN-03;EVN-03;2246014464;AT481 E28.24;-1547;-585;-669;-2801;-2656199;-1860885;-745935;-5263019;-5684060,52;0;0;05/01/2025
31/12/2024;EVN-03;EVN-03;2246014403;AT479 E28.24;-4433;-1464;-1631;-7528;-7611461;-4656984;-1818565;-14087010;-15213970,8;0;0;05/01/2025
31/12/2024;EVN-PĐ;EVN-PĐ;21041898;PĐ472;-23160;-7160;-2880;-33200;-39765720;-22775960;-3211200;-65752880;-71013110,4;0;0;05/01/2025
31/12/2024;EVN-TH;EVN-TH;2046008580;TH486 E11.9;-57709;-18818;-20909;-97436;-100933041;-61007956;-23752624;-185693621;-200549110,7;0;0;05/01/2025
31/12/2024;EVN-TH;EVN-TH;2046008583;TH484 E11.9;0;0;0;0;0;0;0;0;0;0;0;05/01/2025
31/12/2024;EVN-TH;EVN-TH;2110155910;TH476 E11.9;-4972;-2112;-484;-7568;-8696028;-6847104;-549824;-16092956;-17380392,48;0;0;05/01/2025
31/12/2024;EVN-YM;EVN-YM;2346021347;YM 472E28.6;0;0;0;0;0;0;0;0;0;0;0;05/01/2025
31/12/2024;EVN-YM;EVN-YM;2346021369;YM 474E28.6;-80000;-28800;-19200;-128000;-137360000;-91612800;-21408000;-250380800;-270411264;0;0;05/01/2025
31/12/2024;KCN03-001;03-EcoLand;2410883991;AT479 E28.24;12677;4330;4342;21349;24035592;15042420;5388422;44466434;48023748,72;0;0;05/01/2025
31/12/2024;KCN03-002A;03-COFICO;2410883989;AT481 E28.24;4838;1923;2042;8803;9172848;6680502;2534122;18387472;19858469,76;0;0;05/01/2025
31/12/2024;KCN03-003A;03-ANTACO;2410992743;AT479 E28.24;178;63;59;300;337488;218862;73219;629569;679934,52;0;0;05/01/2025
31/12/2024;KCNPĐ-001;PĐ-BQL;2310231609;PĐ472;1349;717;1225;3291;2557704;2490858;1520225;6568787;7094289,96;0;0;05/01/2025
31/12/2024;KCNPĐ-001;PĐ-BQL;2310231610;PĐ472;99;85;109;293;187704;295290;135269;618263;667724,04;0;0;05/01/2025
31/12/2024;KCNPĐ-002;PĐ-AMP;2310231611;PĐ472;21943;6811;1584;30338;41603928;23661414;1965744;67231086;72609572,88;0;0;05/01/2025
31/12/2024;KCNTH-001;TH-BQL;2210575660;TH486 E11.9;3084;1784;1614;6482;5847264;6197616;2002974;14047854;15171682,32;0;0;05/01/2025
31/12/2024;KCNTH-001;TH-BQL;2310396104;TH476 E11.9;0;0;0;0;0;0;0;0;0;0;0;05/01/2025
31/12/2024;KCNTH-001;TH-BQL;2310396108;TH486 E11.9;1277;782;594;2653;2421192;2716668;737154;5875014;6345015,12;0;0;05/01/2025
31/12/2024;KCNTH-002;TH-Asahi;2210575757;TH486 E11.9;38394;12384;12282;63060;72795024;43022016;15241962;131059002;131059002;0;0;05/01/2025
31/12/2024;KCNTH-005;TH-FTA;2410131539;TH486 E11.9;4260;1339;815;6414;8076960;4651686;1011415;13740061;14839265,88;0;0;05/01/2025
31/12/2024;KCNTH-006;TH-Giza;2410131376;TH486 E11.9;4177;1681;856;6714;7919592;5839794;1062296;14821682;16007416,56;0;0;05/01/2025
31/12/2024;KCNTH-007;TH-Sinher;2410131383;TH486 E11.9;4384;1488;1480;7352;8312064;5169312;1836680;15318056;15318056;0;0;05/01/2025
31/12/2024;KCNTH-008;TH-Hum&C;2410320616;TH486 E11.9;26579;12056;6326;44961;50393784;41882544;7850566;100126894;100126894;0;0;05/01/2025
31/12/2024;KCNTH-009A;TH-Hợp Nhất;2410131547;TH486 E11.9;1119;212;69;1400;2121624;736488;85629;2943741;3179240,28;542237;585616;05/01/2025
31/12/2024;KCNTH-010A;TH-SauSum;2410320615;TH486 E11.9;7923;2855;1569;12347;15022008;9918270;1947129;26887407;29038399,56;0;0;05/01/2025
31/12/2024;KCNYM-001;YM-VNC;2310396107;YM 474E28.6;17610;3180;2280;23070;30799890;10309560;2590080;43699530;47195492,4;0;0;05/01/2025
31/12/2024;KCNYM-002A;YM-LiHua;2310396110;YM 474E28.6;36334;13435;11464;61233;68889264;46673190;14226824;129789278;129789278;0;0;05/01/2025
31/12/2024;KCNYM-002A;YM-LiHua;2310396111;YM 474E28.6;18715;7768;5680;32163;35483640;26986032;7048880;69518552;69518552;0;0;05/01/2025
31/12/2024;KCNYM-003;YM-Jili;2310396105;YM 474E28.6;19352;7742;3616;30710;36691392;26895708;4487456;68074556;73520520,48;0;0;05/01/2025
31/12/2024;KCNYM-004;YM-MQ-IDS;2310396106;YM 474E28.6;19360;7668;4916;31944;36706560;26638632;6100756;69445948;75001623,84;0;0;10/01/2025
31/12/2024;KCNYM-005;YM-TITAN;2410121454;YM 474E28.6;3819;1365;1205;6389;11483733;7062510;2205150;20751393;22411504,44;0;0;15/01/2025
31/12/2024;KCNYM-006;YM-Pacific;2410932742;YM 474E28.6;15883;6211;6420;28514;30114168;21577014;7967220;59658402;64431074,16;0;0;15/01/2025
31/12/2024;KCNTH-003;TH-Hợp Lực;2310396109;TH476 E11.9;13643;6110;2230;21983;25867128;21226140;2767430;49860698;53849553,84;0;0;05/01/2025
05/01/2025;KCNTH-011;TH-XuLi;2411290205;TH486 E11.9;0;0;0;0;0;0;0;0;0;0;0;15/01/2025
10/01/2025;EVN-TH;EVN-TH;2046008580;TH486 E11.9;-50600;-17982;-17564;-86146;-88499400;-58297644;-19952704;-166749748;-180089727,8;0;0;15/01/2025
10/01/2025;EVN-TH;EVN-TH;2046008583;TH484 E11.9;0;0;0;0;0;0;0;0;0;0;0;15/01/2025
10/01/2025;EVN-TH;EVN-TH;2110155910;TH476 E11.9;-4576;-2156;-748;-7480;-8003424;-6989752;-849728;-15842904;-17110336,32;0;0;15/01/2025
10/01/2025;EVN-YM;EVN-YM;3001347;YM 472E28.6;-31800;-6840;-4080;-42720;-54600600;-21758040;-4549200;-80907840;-87380467,2;0;0;15/01/2025
10/01/2025;EVN-YM;EVN-YM;2346021347;YM 472E28.6;-7240;-6856;-6736;-20832;-12662760;-22227152;-7652096;-42542008;-45945368,64;0;0;15/01/2025
10/01/2025;EVN-YM;EVN-YM;2346021369;YM 474E28.6;-70320;-24800;-18080;-113200;-122989680;-80401600;-20538880;-223930160;-241844572,8;0;0;15/01/2025
10/01/2025;KCNTH-002;TH-Asahi;2210575757;TH486 E11.9;34800;12534;11706;59040;65980800;43543116;14527146;124051062;124051062;0;0;15/01/2025
10/01/2025;KCNYM-001;YM-VNC;2310396107;YM 474E28.6;14190;3660;1800;19650;24818310;11865720;2044800;38728830;41827136,4;0;0;25/01/2025
10/01/2025;KCNYM-003;YM-Jili;2310396105;YM 474E28.6;24269;8782;3674;36725;46014024;30508668;4559434;81082126;87568696,08;0;0;25/01/2025
10/01/2025;KCNYM-004;YM-MQ-IDS;2310396106;YM 474E28.6;28416;10288;7220;45924;53876736;35740512;8960020;98577268;106463449,4;0;0;25/01/2025
20/01/2025;EVN-YM;EVN-YM;2346021347;YM 472E28.6;-47276;-19128;-12436;-78840;-82685724;-62012976;-14127296;-158825996;-171532075,7;0;0;25/01/2025
20/01/2025;EVN-YM;EVN-YM;3001347;YM 472E28.6;-16740;-4440;-4860;-26040;-28742580;-14123640;-5418900;-48285120;-52147929,6;0;0;25/01/2025
20/01/2025;EVN-YM;EVN-YM;2346021369;YM 474E28.6;-34560;-10720;-7520;-52800;-60445440;-34754240;-8542720;-103742400;-112041792;0;0;25/01/2025
20/01/2025;KCNYM-001;YM-VNC;2310396107;YM 472E28.6;16740;4440;4860;26040;29278260;14394480;5520960;49193700;53129196;0;0;25/01/2025
20/01/2025;KCNYM-003;YM-Jili;2310396105;YM 474E28.6;19510;7819;2163;29492;36990960;27163206;2684283;66838449;72185524,92;0;0;25/01/2025
20/01/2025;KCNYM-004;YM-MQ-IDS;2310396106;YM 474E28.6;23428;8036;6040;37504;44419488;27917064;7495640;79832192;86218767,36;0;0;25/01/2025
20/01/2025;KCNTH-002;TH-Asahi;2210575757;TH486 E11.9;34026;11466;10764;56256;64513296;39832884;13358124;117704304;117704304;0;0;25/01/2025
20/01/2025;EVN-TH;EVN-TH;2046008580;TH486 E11.9;-52691;-18818;-17564;-89073;-92156559;-61007956;-19952704;-173117219;-186966596,5;0;0;07/02/2025
20/01/2025;EVN-TH;EVN-TH;2046008583;TH484 E11.9;0;0;0;0;0;0;0;0;0;0;0;07/02/2025
20/01/2025;EVN-TH;EVN-TH;2110155910;TH476 E11.9;-6336;-2552;-836;-9724;-11081664;-8273584;-949696;-20304944;-21929339,52;0;0;07/02/2025
31/01/2025;KCNYM-001;YM-VNC;2310396107;YM 472E28.6;15540;2520;3960;22020;27179460;8169840;4498560;39847860;43035688,8;0;0;07/02/2025
31/01/2025;KCNYM-002A;YM-LiHua;2310396110;YM 472E28.6;52848;20000;15901;88749;100199808;69480000;19733141;189412949;189412949;0;0;10/02/2025
31/01/2025;KCNYM-002A;YM-LiHua;2310396111;YM 472E28.6;23218;10547;6179;39944;44021328;36640278;7668139;88329745;88329745;0;0;10/02/2025
31/01/2025;KCNYM-003;YM-Jili;2310396105;YM 474E28.6;9094;3562;1531;14187;17242224;12374388;1899971;31516583;34037909,64;0;0;05/02/2025
31/01/2025;KCNYM-004;YM-MQ-IDS;2310396106;YM 474E28.6;13000;5892;3784;22676;24648000;20468808;4695944;49812752;53797772,16;0;0;10/02/2025
31/01/2025;KCNYM-005;YM-TITAN;2410121454;YM 474E28.6;2750;986;1077;4813;8269250;5101564;1970910;15341724;16569061,92;0;0;05/02/2025
31/01/2025;KCNYM-006;YM-Pacific;2410932742;YM 472E28.6;26755;8201;10207;45163;50727480;28490274;12666887;91884641;91884641;0;0;10/02/2025
31/01/2025;KCNTH-001;TH-BQL;2210575660;TH486 E11.9;2812;1564;1817;6193;5331552;5433336;2254897;13019785;14061367,8;0;0;10/02/2025
31/01/2025;KCNTH-001;TH-BQL;2310396104;TH476 E11.9;0;0;0;0;0;0;0;0;0;0;0;05/02/2025
31/01/2025;KCNTH-001;TH-BQL;2310396108;TH486 E11.9;939;618;543;2100;1780344;2146932;673863;4601139;4969230,12;0;0;06/02/2025
31/01/2025;KCNTH-002;TH-Asahi;2210575757;TH486 E11.9;21060;8400;6402;35862;39929760;29181600;7944882;77056242;77056242;0;0;07/02/2025
31/01/2025;KCNTH-003A;TH-Be Bright;2410131387;TH476 E11.9;7650;3576;588;11814;14504400;12423024;729708;27657132;29869702,56;0;0;07/02/2025
31/01/2025;KCNTH-003A;TH-Be Bright;2410131380;TH476 E11.9;0;0;0;0;0;0;0;0;0;0;0;07/02/2025
31/01/2025;KCNTH-005;TH-FTA;2410131539;TH486 E11.9;2566;989;558;4113;4865136;3435786;692478;8993400;9712872;0;0;05/02/2025
31/01/2025;KCNTH-006;TH-Giza;2410131376;TH486 E11.9;2699;1184;842;4725;5117304;4113216;1044922;10275442;11097477,36;0;0;05/02/2025
31/01/2025;KCNTH-007;TH-Sinher;2410131383;TH486 E11.9;2984;1052;1388;5424;5657664;3654648;1722508;11034820;11034820;0;0;05/02/2025
31/01/2025;KCNTH-008;TH-Hum&C;2410320616;TH486 E11.9;19568;8232;6186;33986;37100928;28597968;7676826;73375722;73375722;0;0;05/02/2025
31/01/2025;KCNTH-009A;TH-Hợp Nhất;2410131547;TH486 E11.9;1916;703;225;2844;3632736;2442222;279225;6354183;6862517,64;0;0;10/02/2025
31/01/2025;KCNTH-010A;TH-SauSum;2410320615;TH486 E11.9;6516;2504;1371;10391;12354336;8698896;1701411;22754643;24575014,44;0;0;10/02/2025
31/01/2025;KCNTH-011;TH-XuLi;2411290205;TH486 E11.9;3835;1267;2482;7584;7271160;4401558;3080162;14752880;14752880;0;0;05/02/2025
31/01/2025;KCNPĐ-001;PĐ-BQL;2310231609;PĐ472;1360;697;1238;3295;2578560;2421378;1536358;6536296;7059199,68;0;0;05/02/2025
31/01/2025;KCNPĐ-001;PĐ-BQL;2310231610;PĐ472;0;0;0;0;0;0;0;0;0;0;0;06/02/2025
31/01/2025;KCNPĐ-002;PĐ-AMP;2310231611;PĐ472;21180;7176;1822;30178;40157280;24929424;2261102;67347806;72735630,48;0;0;06/02/2025
31/01/2025;KCN03-002A;03-COFICO;2410883989;AT481 E28.24;7888;3173;3831;14892;14955648;11023002;4754271;30732921;33191554,68;0;0;07/02/2025
31/01/2025;KCN03-001;03-EcoLand;2410883991;AT479 E28.24;13708;5105;5334;24147;25990368;17734770;6619494;50344632;54372202,56;0;0;07/02/2025
31/01/2025;KCN03-003A;03-ANTACO;2410992743;AT479 E28.24;1133;399;411;1943;2148168;1386126;510051;4044345;4367892,6;0;0;07/02/2025
31/01/2025;EVN-YM;EVN-YM;3001347;YM 472E28.6;-15540;-2520;-3960;-22020;-26682180;-8016120;-4415400;-39113700;-42242796;0;0;05/02/2025
31/01/2025;EVN-TH;EVN-TH;2046008580;TH486 E11.9;-34709;-15055;-10455;-60219;-60706041;-48808310;-11876880;-121391231;-131102529,5;0;0;07/02/2025
31/01/2025;EVN-TH;EVN-TH;2046008583;TH484 E11.9;0;0;0;0;0;0;0;0;0;0;0;07/02/2025
31/01/2025;EVN-TH;EVN-TH;2110155910;TH476 E11.9;-3124;-1496;-968;-5588;-5463876;-4850032;-1099648;-11413556;-12326640,48;0;0;11/02/2025
31/01/2025;EVN-PĐ;EVN-PĐ;21041898;PĐ472;-22840;-7840;-3160;-33840;-39216280;-24939040;-3523400;-67678720;-73093017,6;0;0;19/02/2025
31/01/2025;EVN-03;EVN-03;2246014464;AT481 E28.24;-8280;-3304;-4015;-15599;-14216760;-10510024;-4476725;-29203509;-31539789,72;0;0;18/02/2025
31/01/2025;EVN-03;EVN-03;2246014403;AT479 E28.24;-16184;-6022;-6356;-28562;-27787928;-19155982;-7086940;-54030850;-58353318;0;0;18/02/2025
31/01/2025;EVN-YM;EVN-YM;2346021347;YM 472E28.6;-43100;-18488;-11688;-73276;-75381900;-59938096;-13277568;-148597564;-160485369,1;0;0;18/02/2025
31/01/2025;EVN-YM;EVN-YM;2346021369;YM 474E28.6;-560;-240;-240;-1040;-979440;-778080;-272640;-2030160;-2192572,8;0;0;18/02/2025
31/01/2025;KCN03-001;03-EcoLand;2410883994;AT479 E28.24;0;0;0;0;0;0;0;0;0;0;0;01/02/2025
31/01/2025;KCNTH-003;TH-Hợp Lực;2310396109;TH476 E11.9;3308;1396;1169;5873;6271968;4849704;1450729;12572401;13578193,08;0;0;07/02/2025
10/02/2025;KCNYM-001;YM-VNC;2310396107;YM 472E28.6;16260;2160;6570;24990;28438740;7002720;7463520;42904980;46337378,4;0;0;15/02/2025
10/02/2025;KCNYM-003;YM-Jili;2310396105;YM 474E28.6;18000;6434;1680;26114;34128000;22351716;2084880;58564596;63249763,68;0;0;10/02/2025
10/02/2025;KCNYM-004;YM-MQ-IDS;2310396106;YM 474E28.6;16708;6252;4736;27696;31678368;21719448;5877376;59275192;64017207,36;0;0;10/02/2025
10/02/2025;KCNTH-002;TH-Asahi;2210575757;TH486 E11.9;25944;8556;8514;43014;49189824;29723544;10565874;89479242;89479242;0;0;14/02/2025
10/02/2025;EVN-YM;EVN-YM;3001347;YM 472E28.6;-16260;-2160;-6570;-24990;-27918420;-6870960;-7325550;-42114930;-45484124,4;0;0;19/02/2025
10/02/2025;EVN-YM;EVN-YM;2346021347;YM 472E28.6;-64620;-22464;-16422;-103506;-113020380;-72828288;-18655392;-204504060;-220864384,8;0;0;19/02/2025
10/02/2025;EVN-YM;EVN-YM;2346021369;YM 474E28.6;-480;-240;-160;-880;-839520;-778080;-181760;-1799360;-1943308,8;0;0;19/02/2025
10/02/2025;EVN-TH;EVN-TH;2046008580;TH486 E11.9;-39727;-15055;-12545;-67327;-69482523;-48808310;-14251120;-132541953;-143145309,2;0;0;19/02/2025
10/02/2025;EVN-TH;EVN-TH;2046008583;TH476 E11.9;0;0;0;0;0;0;0;0;0;0;0;24/02/2025
10/02/2025;EVN-TH;EVN-TH;2110155910;TH486 E11.9;-1848;-528;-704;-3080;-3232152;-1711776;-799744;-5743672;-6203165,76;0;0;24/02/2025
20/02/2025;KCNYM-003;YM-Jili;2310396105;YM 474E28.6;23512;9827;5728;39067;44578752;34138998;7108448;85826198;92692293,84;0;0;24/02/2025
20/02/2025;KCNYM-004;YM-MQ-IDS;2310396106;YM 474E28.6;24612;10016;7192;41820;46664352;34795584;8925272;90385208;97616024,64;0;0;25/02/2025
20/02/2025;KCNYM-001;YM-VNC;2310396107;YM 472E28.6;22950;4470;7650;35070;40139550;14491740;8690400;63321690;68387425,2;0;0;25/02/2025
20/02/2025;KCNTH-002;TH-Asahi;2210575757;TH486 E11.9;32580;11742;10488;54810;61771680;40791708;13015608;115578996;115578996;0;0;25/02/2025
20/02/2025;EVN-YM;EVN-YM;3001347;YM 472E28.6;-22950;-4470;-7650;-35070;-39405150;-14219070;-8529750;-62153970;-67126287,6;0;0;25/02/2025
20/02/2025;EVN-YM;EVN-YM;2346021347;YM 472E28.6;-85354;-34970;-25678;-146002;-149284146;-113372740;-29170208;-291827094;-315173261,5;0;0;25/02/2025
20/02/2025;EVN-YM;EVN-YM;2346021369;YM 474E28.6;-800;-400;-320;-1520;-1399200;-1296800;-363520;-3059520;-3304281,6;0;0;25/02/2025
20/02/2025;EVN-TH;EVN-TH;2046008580;TH486 E11.9;-52273;-20909;-18400;-91582;-91425477;-67786978;-20902400;-180114855;-194524043,4;0;0;24/02/2025
20/02/2025;EVN-TH;EVN-TH;2046008583;TH476 E11.9;0;0;0;0;0;0;0;0;0;0;0;24/02/2025
20/02/2025;EVN-TH;EVN-TH;2110155910;TH486 E11.9;-2464;-1012;-660;-4136;-4309536;-3280904;-749760;-8340200;-9007416;0;0;24/02/2025
28/02/2025;EVN-YM;EVN-YM;3001347;YM 472E28.6;-30270;-4110;-9690;-44070;-51973590;-13073910;-10804350;-75851850;-81919998;0;0;10/03/2025
28/02/2025;KCNYM-001;YM-VNC;2310396107;YM 472E28.6;30270;4110;9690;44070;52942230;13324620;11007840;77274690;83456665,2;0;0;03/03/2025
28/02/2025;KCNYM-002A;YM-LiHua;2310396110;YM 472E28.6;51568;19960;16507;88035;97772928;69341040;20485187;187599155;187599155;0;0;10/03/2025
28/02/2025;KCNYM-002A;YM-LiHua;2310396111;YM 472E28.6;20122;7778;6920;34820;38151312;27020772;8587720;73759804;73759804;0;0;10/03/2025
28/02/2025;KCNYM-003;YM-Jili;2310396105;YM 474E28.6;19963;7405;7075;34443;37849848;25724970;8780075;72354893;78143284,44;0;0;05/03/2025
28/02/2025;KCNYM-004;YM-MQ-IDS;2310396106;YM 474E28.6;18648;7444;4960;31052;35356608;25860456;6155360;67372424;72762217,92;0;0;05/03/2025
28/02/2025;KCNYM-005;YM-TITAN;2410121454;YM 474E28.6;2198;970;710;3878;6609386;5018780;1299300;12927466;13961663,28;0;0;10/03/2025
28/02/2025;KCNYM-006;YM-Pacific;2410932742;YM 472E28.6;20587;7214;7090;34891;39032952;25061436;8798690;72893078;72893078;0;0;08/03/2025
28/02/2025;KCNTH-001;TH-BQL;2210575660;TH486 E11.9;3158;1675;2132;6965;5987568;5818950;2645812;14452330;15608516,4;0;0;06/03/2025
28/02/2025;KCNTH-001;TH-BQL;2310396104;TH486 E11.9;0;0;0;0;0;0;0;0;0;0;0;06/03/2025
28/02/2025;KCNTH-001;TH-BQL;2310396108;TH476 E11.9;1358;750;716;2824;2574768;2605500;888556;6068824;6554329,92;0;0;06/03/2025
28/02/2025;KCNTH-002;TH-Asahi;2210575757;TH486 E11.9;23976;8280;7746;40002;45458496;28764720;9612786;83836002;83836002;0;0;05/03/2025
28/02/2025;KCNTH-003A;TH-Be Bright;2410131387;TH476 E11.9;4152;1674;834;6660;7872192;5815476;1034994;14722662;15900474,96;0;0;07/03/2025
28/02/2025;KCNTH-003A;TH-Be Bright;2410131380;TH476 E11.9;0;0;0;0;0;0;0;0;0;0;0;07/03/2025
28/02/2025;KCNTH-005;TH-FTA;2410131539;TH486 E11.9;3340;1258;350;4948;6332640;4370292;434350;11137282;12028264,56;0;0;04/03/2025
28/02/2025;KCNTH-006;TH-Giza;2410131376;TH486 E11.9;158;55;41;254;299568;191070;50881;541519;584840,52;0;0;07/03/2025
28/02/2025;KCNTH-007;TH-Sinher;2410131383;TH486 E11.9;3580;1228;1340;6148;6787680;4266072;1662940;12716692;12716692;0;0;05/03/2025
28/02/2025;KCNTH-008;TH-Hum&C;2410320616;TH486 E11.9;21277;12294;5627;39198;40341192;42709356;6983107;90033655;90033655;0;0;05/03/2025
28/02/2025;KCNTH-009A;TH-Hợp Nhất;2410131547;TH486 E11.9;1063;504;238;1805;2015448;1750896;295358;4061702;4386638,16;0;0;11/03/2025
28/02/2025;KCNTH-010A;TH-SauSum;2410320615;TH486 E11.9;6980;2611;1128;10719;13234080;9070614;1399848;23704542;25600905,36;0;0;04/03/2025
28/02/2025;KCNTH-011;TH-XuLi;2411290205;TH486 E11.9;6540;2138;1802;10480;12399840;7427412;2236282;22063534;22063534;0;0;05/03/2025
28/02/2025;KCN03-002A;03-COFICO;2410883989;AT481 E28.24;6299;2617;3020;11936;11942904;9091458;3747820;24782182;26764756,56;0;0;06/03/2025
28/02/2025;KCN03-001;03-EcoLand;2410883991;AT479 E28.24;9114;3636;3809;16559;17280144;12631464;4726969;34638577;37409663,16;0;0;07/03/2025
28/02/2025;KCN03-003A;03-ANTACO;2410992743;AT479 E28.24;1487;515;447;2449;2819352;1789110;554727;5163189;5576244,12;0;0;04/03/2025
28/02/2025;KCN03-001;03-EcoLand;2410883994;AT479 E28.24;582;310;403;1295;1103472;1076940;500123;2680535;2894977,8;0;0;07/03/2025
28/02/2025;KCNPĐ-001;PĐ-BQL;2310231609;PĐ472;1280;628;1178;3086;2426880;2181672;1461898;6070450;6556086;0;0;10/03/2025
28/02/2025;KCNPĐ-001;PĐ-BQL;2310231610;PĐ472;0;0;0;0;0;0;0;0;0;0;0;10/03/2025
28/02/2025;KCNPĐ-002;PĐ-AMP;2310231611;PĐ472;15744;4872;1481;22097;29850624;16925328;1837921;48613873;52502982,84;0;0;03/03/2025
28/02/2025;EVN-YM;EVN-YM;2346021347;YM 472E28.6;-66066;-25794;-20598;-112458;-115549434;-83624148;-23399328;-222572910;-240378742,8;0;0;10/03/2025
28/02/2025;EVN-YM;EVN-YM;2346021369;YM 474E28.6;-960;-400;-240;-1600;-1679040;-1296800;-272640;-3248480;-3508358,4;0;0;10/03/2025
28/02/2025;EVN-03;EVN-03;2246014464;AT481 E28.24;-6691;-2718;-3178;-12587;-11702559;-8811756;-3610208;-24124523;-26054484,84;0;0;04/03/2025
28/02/2025;EVN-03;EVN-03;2246014403;AT479 E28.24;-11625;-4475;-4893;-20993;-20332125;-14507950;-5558448;-40398523;-43630404,84;0;0;04/03/2025
28/02/2025;EVN-PĐ;EVN-PĐ;21041898;PĐ472;-17240;-5480;-2720;-25440;-29601080;-17431880;-3032800;-50065760;-54071020,8;0;0;05/03/2025
28/02/2025;EVN-TH;EVN-TH;2046008580;TH486 E11.9;-41818;-16309;-10873;-69000;-73139682;-52873778;-12351728;-138365188;-149434403;0;0;04/03/2025
28/02/2025;EVN-TH;EVN-TH;2046008583;TH476 E11.9;0;0;0;0;0;0;0;0;0;0;0;04/03/2025
28/02/2025;EVN-TH;EVN-TH;2110155910;TH486 E11.9;-2860;-1276;-616;-4752;-5002140;-4136792;-699776;-9838708;-10625804,64;0;0;04/03/2025
28/02/2025;KCNTH-003;TH-Hợp Lực;2310396109;TH476 E11.9;1864;845;725;3434;3534144;2935530;899725;7369399;7958950,92;0;0;04/03/2025
09/03/2025;KCNTH-003;TH-Hợp Lực;2310396109;TH476 E11.9;539;224;160;923;1021944;778176;198560;1998680;2158574,4;0;0;
10/03/2025;KCNTH-002;TH-Asahi;2210575757;TH486 E11.9;32016;9936;10716;52668;60702336;34517664;13298556;108518556;108518556;0;0;14/03/2025
10/03/2025;EVN-YM;EVN-YM;3001347;YM 472E28.6;-30840;-6000;-8820;-45660;-52952280;-19086000;-9834300;-81872580;-88422386,4;0;0;
10/03/2025;KCNYM-001;YM-VNC;2310396107;YM 472E28.6;30840;6000;8820;45660;53939160;19452000;10019520;83410680;90083534,4;0;0;
10/03/2025;KCNYM-002A;YM-LiHua;2310396110;YM 472E28.6;18939;7968;6317;33224;35908344;27680832;7839397;71428573;71428573;0;0;
10/03/2025;KCNYM-002A;YM-LiHua;2310396111;YM 472E28.6;7982;3624;3277;14883;15133872;12589776;4066757;31790405;31790405;0;0;
10/03/2025;KCNYM-003;YM-Jili;2310396105;YM 474E28.6;23738;7883;8194;39815;45007248;27385542;10168754;82561544;89166467,52;0;0;13/03/2025
10/03/2025;KCNYM-004;YM-MQ-IDS;2310396106;YM 474E28.6;20920;8600;4932;34452;39664320;29876400;6120612;75661332;81714238,56;0;0;
10/03/2025;EVN-TH;EVN-TH;2046008580;TH486 E11.9;-52691;-18400;-19655;-90746;-92156559;-59652800;-22328080;-174137439;-188068434,1;0;0;
10/03/2025;EVN-TH;EVN-TH;2046008583;TH476 E11.9;0;0;0;0;0;0;0;0;0;0;0;
10/03/2025;EVN-TH;EVN-TH;2110155910;TH486 E11.9;-3124;-1364;-660;-5148;-5463876;-4422088;-749760;-10635724;-11486581,92;0;0;
10/03/2025;EVN-YM;EVN-YM;2346021347;YM 472E28.6;-74696;-29232;-23228;-127156;-130643304;-94770144;-26387008;-251800456;-271944492,5;0;0;
10/03/2025;EVN-YM;EVN-YM;2346021369;YM 474E28.6;-2960;-880;-880;-4720;-5177040;-2852960;-999680;-9029680;-9752054,4;0;0;
